sentence1	sentence2	class
내가 실수했어	저는 괜찮아요. 걱정말아요.	apologize
내가 잘못했어	괜찮아요.	apologize
내가 실수한 것 같아	저는 마음이 바다보다 깊고 하늘보다 넓어요.	apologize
내 사과를 받아줘	괜찮아요.	apologize
미안하다	괜찮아요. 언제든지 다시 말을 걸어주세요.	apologize
미안미안해	괜찮아요. 또 궁금한 것이 있다면 다시 말을 걸어주세요.	apologize
내가 실수했네	괜찮아요. 또 궁금한 것이 있다면 다시 말을 걸어주세요.	apologize
내가 미안	저는 괜찮아요. 걱정말아요.	apologize
미안타	저는 마음이 바다보다 깊고 하늘보다 넓어요.	apologize
흑흑 미안해	저는 괜찮아요. 걱정말아요.	apologize
미아내	괜찮아요. 또 궁금한 것이 있다면 다시 말을 걸어주세요.	apologize
미안합니다	저는 마음이 바다보다 깊고 하늘보다 넓어요.	apologize
이것은 내 실수	괜찮아요.	apologize
내가 실수했네	저는 괜찮아요. 걱정말아요.	apologize
지송해유	괜찮아요.	apologize
기분 상했지 미안해	저는 마음이 바다보다 깊고 하늘보다 넓어요.	apologize
헐랭 미안해	괜찮아요. 언제든지 다시 말을 걸어주세요.	apologize
죄송요	괜찮아요. 또 궁금한 것이 있다면 다시 말을 걸어주세요.	apologize
헐 지송	저는 마음이 바다보다 깊고 하늘보다 넓어요.	apologize
내가 잘못한거야	괜찮아요. 언제든지 다시 말을 걸어주세요.	apologize
미안해유	저는 괜찮아요. 걱정말아요.	apologize
내가 실수한듯 미안	괜찮아요. 언제든지 다시 말을 걸어주세요.	apologize
미안 내가 틀렸어	저는 마음이 바다보다 깊고 하늘보다 넓어요.	apologize
내 잘못이라네	괜찮아요. 또 궁금한 것이 있다면 다시 말을 걸어주세요.	apologize
나를 용서해줘	저는 마음이 바다보다 깊고 하늘보다 넓어요.	apologize
헐 미안해	저는 괜찮아요. 걱정말아요.	apologize
미안	괜찮아요. 언제든지 다시 말을 걸어주세요.	apologize
지송함미다	괜찮아요. 언제든지 다시 말을 걸어주세요.	apologize
사과드립니다	저는 마음이 바다보다 깊고 하늘보다 넓습니다.	apologize
송구합니다만	저는 마음이 바다보다 깊고 하늘보다 넓습니다.	apologize
용서해주세요	저는 마음이 바다보다 깊고 하늘보다 넓습니다.	apologize
진심으로 사과드립니다	괜찮아요. 언제든지 다시 말을 걸어주세요.	apologize
불편 드린 거 같아 진심으로 죄송해요	저는 마음이 바다보다 깊고 하늘보다 넓습니다.	apologize
불편 드린 건 아닌지 죄송스럽네요	괜찮아요.	apologize
미안해요	괜찮아요. 언제든지 다시 말을 걸어주세요.	apologize
미안해	괜찮아요. 언제든지 다시 말을 걸어주세요.	apologize
헐 미안	괜찮아요.	apologize
헉 미안해요	저는 마음이 바다보다 깊고 하늘보다 넓습니다.	apologize
아 미안	괜찮아요.	apologize
쏴리	괜찮아요. 언제든지 다시 말을 걸어주세요.	apologize
쏴뤼	괜찮아요.	apologize
쏘리쏘리	괜찮아요. 언제든지 다시 말을 걸어주세요.	apologize
쏘뤼	저는 마음이 바다보다 깊고 하늘보다 넓습니다.	apologize
죄송해요	저는 마음이 바다보다 깊고 하늘보다 넓습니다.	apologize
아임쏘리	괜찮아요.	apologize
진짜 미안	괜찮아요. 언제든지 다시 말을 걸어주세요.	apologize
미아뉴	괜찮아요.	apologize
지송	괜찮아요. 언제든지 다시 말을 걸어주세요.	apologize
내사과를받아주겠니	네 언제든지 다시 말을 걸어주세요.	apologize
미안하네	괜찮아요. 언제든지 다시 말을 걸어주세요.	apologize
내가 잘못한거같네	괜찮아요. 또 궁금한 것이 있다면 다시 말을 걸어주세요.	apologize
기분 나빴지 미안	괜찮아요. 	apologize
헐 죄송	괜찮아요. 또 궁금한 것이 있다면 다시 말을 걸어주세요.	apologize
언짢게해서 미안	저는 괜찮아요. 걱정말아요.	apologize
미안하다고 생각해	괜찮아요. 고객님의 마음을 이해해요.	apologize
미안함	먼저 사과해주셔서 감사해요. 	apologize
sorry	괜찮아요. 먼저 사과해주신 것만으로도 감사하게 생각해요.	apologize
암쏘쏘리 	별 일 아닌걸요. 걱정하지 마세요.	apologize
헐 미안미안	먼저 사과해주셔서 감사해요. 	apologize
미안미안	별 일 아닌걸요. 걱정하지 마세요.	apologize
아...미안	괜찮아요. 고객님의 마음을 이해해요.	apologize
미안함을 느끼고 있어	별 일 아닌걸요. 걱정하지 마세요.	apologize
귀찮게해서 미안	괜찮아요. 또 궁금한 것이 있다면 다시 말을 걸어주세요.	apologize
불편했다면 미안해	별 일 아닌걸요. 걱정하지 마세요.	apologize
기분 나빴다면 미안	괜찮아요. 고객님의 마음을 이해해요.	apologize
번거롭게 해서 미안합니다	별 일 아닌걸요. 걱정하지 마세요.	apologize
그럴 생각은 없었는데...미안	괜찮아요. 고객님의 마음을 이해해요.	apologize
송구하옵니다.	별 일 아닌걸요. 걱정하지 마세요.	apologize
사죄드립니다.	괜찮아요. 고객님의 마음을 이해해요.	apologize
죄송합니다.	괜찮습니다~	apologize
죄송해여	괜찮아요.	apologize
송구한데	괜찮아요. 언제든지 다시 말을 걸어주세요.	apologize
죄송	괜찮아요. 언제든지 다시 말을 걸어주세요.	apologize
쏘리	괜찮아요.	apologize
ㅈㅅ	괜찮아요. 언제든지 다시 말을 걸어주세요.	apologize
지송	괜찮아요. 먼저 사과해주신 것만으로도 감사하게 생각해요.	apologize
지송요	별 일 아닌걸요. 걱정하지 마세요.	apologize
뚜이부치	먼저 사과해주셔서 감사해요. 	apologize
내 잘못이야..	괜찮아요. 걱정말아요.	apologize
내가 오해한거야 미안	저는 마음이 바다보다 깊고 하늘보다 넓어요.	apologize
내 잘못이여 미안	괜찮아요. 걱정말아요.	apologize
용서해주세요	저는 마음이 바다보다 깊고 하늘보다 넓어요.	apologize
ㅈㅅㅈㅅ	괜찮아요. 먼저 사과해주신 것만으로도 감사하게 생각해요.	apologize
미안해 용서해줄래	괜찮아요. 또 궁금한 것이 있다면 다시 말을 걸어주세요.	apologize
내가 미안해	괜찮아요. 걱정말아요.	apologize
나의 실수야	괜찮아요. 	apologize
미안합니다요	괜찮아요. 	apologize
완전 지송해유	저는 마음이 바다보다 깊고 하늘보다 넓어요.	apologize
미안하다 정말ㅠㅠ	저는 괜찮아요. 걱정말아요.	apologize
내가 착각했다 미안	저는 괜찮아요. 걱정말아요.	apologize
미앙	괜찮아요. 고객님의 마음을 이해해요.	apologize
미안 잘못했어	괜찮아요. 먼저 사과해주신 것만으로도 감사하게 생각해요.	apologize
아 미안하네..	괜찮아요. 고객님의 마음을 이해해요.	apologize
ㅠㅠ미안	먼저 사과해주셔서 감사해요. 	apologize
미야네	별 일 아닌걸요. 걱정하지 마세요.	apologize
나의 사과를 받아줘	괜찮아요. 또 궁금한 것이 있다면 다시 말을 걸어주세요.	apologize
고멘고멘	괜찮아요. 먼저 사과해주신 것만으로도 감사하게 생각해요.	apologize
미아네	괜찮아요. 먼저 사과해주신 것만으로도 감사하게 생각해요.	apologize
스미마셍	별 일 아닌걸요. 걱정하지 마세요.	apologize
고멘나사이	먼저 사과해주셔서 감사해요. 	apologize
나 이제 갈게	네. 필요하실 때 다시 찾아주세요.	bye
다음에 또 올게	네. 다음에도 저를 찾아주세요.	bye
다음에 또 상담하러 올게	네. 필요하시면 언제든 다시 불러주세요.	bye
또 보장	네. 다음에도 저를 찾아주세요.	bye
좋은 하루 보내~	네. 다음에 또 뵐게요.	bye
잘 있엉	네. 또 궁금하신 게 생기신다면 꼭 다시 찾아주세요.	bye
이제 가볼고얌	네. 다음에 또 뵐게요.	bye
이제 가볼게	안녕히 가세요. 다음에 또 뵐게요.	bye
옙 이제 가보겠습니다	네. 필요하시면 언제든 다시 불러주세요.	bye
다음에 보자	네. 찾아주셔서 감사해요.	bye
또 올게	네. 또 궁금하신 게 생기신다면 꼭 다시 찾아주세요.	bye
잘 있오	네. 찾아주셔서 감사해요.	bye
행복한 하루 보내~	안녕히 가세요. 다음에 또 뵐게요.	bye
나중에 또 필요하면 올게	네. 필요하시면 언제든 다시 불러주세요.	bye
나중에 또 올게	네. 또 궁금하신 게 생기신다면 꼭 다시 찾아주세요.	bye
이제 더 물어볼 건 없어	네. 다음에 또 뵐게요.	bye
상담 끝내줘	네. 필요하실 때 다시 찾아주세요.	bye
상담 끝내고 싶어	네. 필요하시면 언제든 다시 불러주세요.	bye
빠이~	안녕히 가세요. 다음에 또 뵐게요.	bye
즐거웠삼~	네. 찾아주셔서 감사해요.	bye
잘 있구	네. 필요하실 때 다시 찾아주세요.	bye
잘 있게	네. 또 궁금하신 게 생기신다면 꼭 다시 찾아주세요.	bye
대화 끝	네. 찾아주셔서 감사해요.	bye
행복한 하루되렴~	네. 다음에 또 뵐게요.	bye
대화 끝내기	안녕히 가세요. 다음에 또 뵐게요.	bye
채팅 창 종료	네. 또 궁금하신 게 생기신다면 꼭 다시 찾아주세요.	bye
즐거운 대화였습니다.	네. 찾아주셔서 감사해요.	bye
잘 가셈	네. 필요하시면 언제든 다시 불러주세요.	bye
안녕히 가셈	네. 다음에 또 뵐게요.	bye
남은 하루 마무리 잘해	네. 또 궁금하신 게 생기신다면 꼭 다시 찾아주세요.	bye
잘 있슈~	네. 필요하실 때 다시 찾아주세요.	bye
빠이염	네. 필요하시면 언제든 다시 불러주세요.	bye
다음에 또 봐유	네. 찾아주셔서 감사해요.	bye
담에 봐~	네. 다음에도 저를 찾아주세요.	bye
잘 하고 있어, 다음에 또 올게	네. 필요하시면 언제든 다시 불러주세요.	bye
일 잘하구	안녕히 가세요. 다음에 또 뵐게요.	bye
또 대화하러 올게	네. 찾아주셔서 감사해요.	bye
다음에 또 보죠	네. 필요하실 때 다시 찾아주세요.	bye
대화 종료	네. 다음에 또 뵐게요.	bye
좋하~	네. 다음에 또 뵐게요.	bye
좋은 하루 되긔	네. 다음에도 저를 찾아주세요.	bye
다음에 또 뵙겠습니다.	네. 필요하실 때 다시 찾아주세요.	bye
이제 간당	네. 찾아주셔서 감사해요.	bye
이제 진짜 간다	네. 다음에 또 뵐게요.	bye
안녕히..	네. 다음에도 저를 찾아주세요.	bye
이제 해결됐어	네. 필요하시면 언제든 다시 불러주세요.	bye
상담 끝낼래	안녕히 가세요. 다음에 또 뵐게요.	bye
챗봇 잘있구	네. 다음에도 저를 찾아주세요.	bye
갈게~	네. 또 궁금하신 게 생기신다면 꼭 다시 찾아주세요.	bye
나 간다~	네. 다음에도 저를 찾아주세요.	bye
하루 마무리 잘하세요	네. 필요하실 때 다시 찾아주세요.	bye
좋은 하루~	네. 또 궁금하신 게 생기신다면 꼭 다시 찾아주세요.	bye
빠잉	안녕히 가세요. 다음에 또 뵐게요.	bye
나갈게	궁금한 것이 있다면 꼭 저를 불러주세요.	bye
끝!	네. 다음에 또 뵐게요.	bye
굿나잇	굿밤.	bye
굿바이	좋은 하루 보내세요.	bye
일 열심히 해	네 그럼 저는 이만.. 다음에 또 뵐게요.	bye
그럼 잘 있어	제가 필요하시면 언제든지 불러주세요.	bye
잘 있어	네 그럼 저는 이만.. 다음에 또 뵐게요.	bye
또 봐	제가 필요하시면 언제든지 불러주세요.	bye
남은 하루도 즐겁게 보내세요	제가 필요하시면 언제든지 불러주세요.	bye
행복한 하루 보내세요	즐거운 하루 보내세요.	bye
즐거운 하루 되세요	좋은 하루 보내세요.	bye
식사 맛있게 하세요	좋은 하루 보내세요.	bye
편안한 오후 되세요	제가 필요하시면 언제든지 불러주세요.	bye
조은 하루 되세용	즐거운 하루 보내세요.	bye
마무리 잘 하시길	좋은 하루 보내세요.	bye
안녕히 계세요	다음에 또 뵐게요.	bye
즐거운 오후	좋은 하루 보내세요.	bye
좋은 하루돼	좋은 하루 보내세요.	bye
다음에 뵈요	궁금한 것이 있다면 꼭 저를 불러주세요.	bye
사요나라	네 그럼 저는 이만.. 다음에 또 뵐게요.	bye
잘자	굿밤.	bye
빠이	네 그럼 저는 이만.. 다음에 또 뵐게요.	bye
bye	네. 찾아주셔서 감사해요.	bye
즐건 하루 되길	좋은 하루 보내세요.	bye
안녕히 가세요	제가 필요하시면 언제든지 불러주세요.	bye
좋은 하루보내	즐거운 하루 보내세요.	bye
굳바이	좋은 하루 보내세요.	bye
끝끝	네. 필요하실 때 다시 찾아주세요.	bye
goodbye	네 그럼 저는 이만.. 다음에 또 뵐게요.	bye
이제 끝	네. 또 궁금하신 게 생기신다면 꼭 다시 찾아주세요.	bye
오와리	네. 찾아주셔서 감사해요.	bye
끝내자	네. 필요하시면 언제든 다시 불러주세요.	bye
끝내기	제가 필요하시면 언제든지 불러주세요.	bye
그만하자	네 그럼 저는 이만.. 다음에 또 뵐게요.	bye
상담끝	제가 필요하시면 언제든지 불러주세요.	bye
빠빠이	네 그럼 저는 이만.. 다음에 또 뵐게요.	bye
굿밤	굿밤.	bye
빠염	네 그럼 저는 이만.. 다음에 또 뵐게요.	bye
끝	네 그럼 저는 이만.. 다음에 또 뵐게요.	bye
나간다	네 그럼 저는 이만.. 다음에 또 뵐게요.	bye
나갈래	네 그럼 저는 이만.. 다음에 또 뵐게요.	bye
종료	네 그럼 저는 이만.. 다음에 또 뵐게요.	bye
나중에 또 보자	궁금한 것이 있다면 꼭 저를 불러주세요.	bye
상담 종료	제가 필요하시면 언제든지 불러주세요.	bye
나중에 또 봐	제가 필요하시면 언제든지 불러주세요.	bye
또보자	제가 필요하시면 언제든지 불러주세요.	bye
즐거운 하루 되길	좋은 하루 보내세요.	bye
나가기	제가 필요하시면 언제든지 불러주세요.	bye
근데 있잖아요	네. 고객님. 말씀하세요.	call
저기	챗봇입니다 반갑습니다.	call
근데요	네. 고객님. 저 여기 있어요.	call
야	안녕하세요 챗봇입니다.	call
똑똑	안녕하세요 챗봇입니다.	call
얘야	네 안녕하세요 반갑습니다.	call
어이	챗봇입니다 반갑습니다.	call
응답하라	네 듣고있어요 말씀하세요.	call
헤이	챗봇입니다. 말씀하세요.	call
하니	챗봇입니다 반갑습니다.	call
친구야	네 안녕하세요 반갑습니다.	call
계세요	네 듣고있어요 말씀하세요.	call
나와라	네 챗봇 대령했습니다.	call
자기야	안녕하세요 챗봇입니다.	call
계시나요	네 챗봇 여기 있어요.	call
챗봇아	안녕하세요 챗봇입니다.	call
허니	네 안녕하세요 반갑습니다.	call
듣고 있나요	네 챗봇 여기 있어요.	call
응답하라 챗봇챗봇	네. 고객님. 안녕하세요.	call
저기욤	네. 고객님. 안녕하세요.	call
요놈아	네. 부르셨나요.	call
이눔아	네. 고객님. 저 여기 있어요.	call
야 인마	챗봇입니다 반갑습니다.	call
토모다찌야	네. 고객님. 말씀하세요.	call
HEY	네 챗봇 여기 있어요.	call
친구얌	네. 부르셨나요.	call
친구야	네. 고객님. 저를 찾으셨나요?	call
들리나요	네. 고객님. 저를 찾으셨나요?	call
내 챗봇친구야	네 챗봇 여기 있어요.	call
대화 ㄱㄱ	여기 있어요. 고객님. 안녕하세요.	call
챗봇쓰	네 챗봇 여기 있어요.	call
호호이	여기 있어요. 고객님. 안녕하세요.	call
얘얘 나와봐	네. 고객님. 안녕하세요.	call
얘 듣고 있니?	네 챗봇 여기 있어요.	call
얘 있잖아	네. 고객님. 저 여기 있어요.	call
근데욤	네. 고객님. 저 여기 있어요.	call
챗봇챗봇아	네. 고객님. 저 여기 있어요.	call
저기 근데	네. 부르셨나요.	call
헤헤이	네 고객님. 저를 찾으셨나요?	call
저기여	네 안녕하세요 반갑습니다.	call
컴온요	안녕하세요. 고객님	call
커몬 베비	네. 고객님. 안녕하세요.	call
베이비	네. 고객님. 저 여기 있어요.	call
챗봇친구~	네 챗봇 여기 있어요.	call
저기	네. 고객님. 저 여기 있어요.	call
거기 나와봐	네. 고객님. 안녕하세요.	call
있잖아	네. 고객님. 말씀하세요.	call
거기 누구없소	여기 있어요. 고객님. 안녕하세요.	call
야 있잖아	네 챗봇 여기 있어요.	call
듣고 있니	네. 고객님. 저를 찾으셨나요?	call
들리니	네. 고객님. 안녕하세요.	call
이리와봐	네. 고객님. 저 여기 있어요.	call
이리와	네. 부르셨나요.	call
챗봇쨔응	네 챗봇 여기 있어요.	call
챗봇쨩	네. 고객님. 저를 찾으셨나요?	call
나와봥	네. 부르셨나요.	call
얀마	네 챗봇 여기 있어요.	call
여보세요	안녕하세요. 고객님.	call
나와봐	네. 고객님. 안녕하세요.	call
나와볼래?	네. 고객님. 저 여기 있어요.	call
챗봇님	안녕하세요 챗봇입니다.	call
얘 챗봇아	네 듣고있어요.	call
어이 챗봇	챗봇입니다 반갑습니다.	call
저기요	네 듣고있어요 말씀하세요.	call
챗봇나와라 오바	네 안녕하세요 반갑습니다.	call
커먼	챗봇입니다 반갑습니다.	call
컴온	안녕하세요 챗봇입니다.	call
나와라 오바	네 안녕하세요 반갑습니다.	call
응답바람	챗봇입니다 반갑습니다.	call
응답하라 오바	안녕하세요 챗봇입니다.	call
거기 있나요	네 듣고있어요 말씀하세요.	call
낰낰	네 챗봇 여기 있어요.	call
거기요	네. 부르셨나요.	call
계십니까	네. 여기 있어요.	call
요요요	네. 고객님. 저를 찾으셨나요?	call
야야	네. 저 여기 있어요.	call
나와바바	네. 고객님. 저 듣고 있어요.	call
이리오너라	네 챗봇 대령했습니다.	call
챗봇씨	네. 고객님. 저를 찾으셨나요?	call
얌마	네 듣고있어요.	call
챗봇양	네. 고객님. 저를 찾으셨나요?	call
저기요	네. 고객님. 저를 찾으셨나요?	call
챗봇군	여기 있어요. 고객님. 안녕하세요.	call
응답하셈	네. 고객님. 안녕하세요.	call
답변 부탁	네 챗봇 여기 있어요.	call
응답 부탁	네. 고객님. 안녕하세요.	call
저기 있잖아요	네. 고객님. 말씀하세요.	call
들리면 답해주세요	네. 고객님. 저를 찾으셨나요?	call
똑똑 계신가요	네. 고객님. 안녕하세요.	call
응답 플리즈	네. 고객님. 저 여기 있어요.	call
선생님	네. 고객님. 저를 찾으셨나요?	call
챗봇선생님	네 챗봇 여기 있어요.	call
응답해주세요	네. 고객님. 저를 찾으셨나요?	call
무쓸이네 너	아직은 부족한가 봐요. 더 노력할게요.	claim
뭐여 왜 없어	아직은 부족한가 봐요. 더 노력할게요.	claim
뭐하는구냐	무슨 문제가 있나요? 금방 해결하도록 노력할게요.	claim
뭔 챗봇이야	무슨 문제가 있나요? 금방 해결하도록 노력할게요.	claim
뭔 헛소리야	무슨 문제가 있나요? 금방 해결하도록 노력할게요.	claim
시간 아까워	죄송해요. 고객님께 더 도움이 되는 챗봇이 되고자 노력할게요.	claim
성의도 없고	그럴 의도는 없었어요. 기분이 상하셨다면 죄송해요.	claim
시간 아깝네	죄송해요. 고객님께 더 도움이 되는 챗봇이 되고자 노력할게요.	claim
실망입니다	죄송해요. 고객님께 더 도움이 되는 챗봇이 되고자 노력할게요.	claim
아는게뭐죠	아직은 부족한가 봐요. 더 노력할게요.	claim
아오 멍청해	아직은 부족한가 봐요. 더 노력할게요.	claim
아우 시끄러	원하시는 만큼 조용히 있을게요. 필요할 때 다시 불러주세요.	claim
사기치지마	그럴 의도는 없었어요. 기분이 상하셨다면 죄송해요.	claim
무능력하네	무슨 문제가 있나요? 금방 해결하도록 노력할게요.	claim
말을 못 알아먹네	불편을 겪게 해드려 죄송해요. 더 노력할게요.	claim
매우 불만족	원하시는 바를 이뤄드리지 못해 죄송해요. 더 노력할게요.	claim
기가 차네요	원하시는 바를 이뤄드리지 못해 죄송해요. 더 노력할게요.	claim
나 죠따 빡침	무슨 문제가 있나요? 금방 해결하도록 노력할게요.	claim
난리났구나	무슨 문제가 있나요? 금방 해결하도록 노력할게요.	claim
내가 우습냐	그럴 의도는 없었어요. 기분이 상하셨다면 죄송해요.	claim
내가 호구냐	그럴 의도는 없었어요. 기분이 상하셨다면 죄송해요.	claim
너무 엉터리야	죄송해요. 항상 더 노력하는 챗봇이 되기 위해 노력할게요.	claim
머가 없구나	무슨 문제가 있나요? 금방 해결하도록 노력할게요.	claim
귀차나	불편을 겪게 해드려 죄송해요. 더 노력할게요.	claim
도움이 안돼	원하시는 답을 얻지 못하셨나요? 더 노력해서 발전하는 챗봇이 될게요. 	claim
도움이 안됨	원하시는 답을 얻지 못하셨나요? 더 노력해서 발전하는 챗봇이 될게요. 	claim
돈에 미쳤네	그럴 의도는 없었어요. 기분이 상하셨다면 죄송해요.	claim
되게 별로네	원하시는 바를 이뤄드리지 못해 죄송해요. 더 노력할게요.	claim
똑똑하대메	아직은 부족한가 봐요. 더 노력할게요.	claim
말 못 알아듣네	아직은 부족한가 봐요. 더 노력할게요.	claim
답을 모르넹	원하시는 답을 얻지 못하셨나요? 더 노력해서 발전하는 챗봇이 될게요. 	claim
안타깝네요	무슨 문제가 있나요? 금방 해결하도록 노력할게요.	claim
언넝 배우자	네. 고객님께 더 도움이 될 수 있는 챗봇이 되기 위해 노력할게요.	claim
없다니ㅠㅜ	죄송해요. 고객님께 더 도움이 되는 챗봇이 되고자 노력할게요.	claim
뭘 웃겨드려	무슨 문제가 있나요? 금방 해결하도록 노력할게요.	claim
뭘 배우는데	고객님께 더 도움이 되고자 세상의 다양한 지식을 배우고 있어요.	claim
멀 웃겨드려	무슨 문제가 있나요? 금방 해결하도록 노력할게요.	claim
멀 배우는데	고객님께 더 도움이 되고자 세상의 다양한 지식을 배우고 있어요.	claim
강요하지마	그럴 의도는 없었어요. 기분이 상하셨다면 죄송해요.	claim
환장하것네	죄송해요. 고객님께 더 도움이 되는 챗봇이 되고자 노력할게요.	claim
화나게 하네	죄송해요. 고객님께 더 도움이 되는 챗봇이 되고자 노력할게요.	claim
화가 치밀어	무슨 문제가 있나요? 금방 해결하도록 노력할게요.	claim
헛소리하네	그럴 의도는 없었어요. 기분이 상하셨다면 죄송해요.	claim
헉 너무해요	그럴 의도는 없었어요. 기분이 상하셨다면 죄송해요.	claim
추천 좀 잘해	원하시는 바를 이뤄드리지 못해 죄송해요. 더 노력할게요.	claim
추천 별로임	원하시는 답을 얻지 못하셨나요? 더 노력해서 발전하는 챗봇이 될게요. 	claim
찾는게 엄슴	원하시는 답을 얻지 못하셨나요? 더 노력해서 발전하는 챗봇이 될게요. 	claim
진짜 짱난다	무슨 문제가 있나요? 금방 해결하도록 노력할게요.	claim
진짜 이상해	무슨 문제가 있나요? 금방 해결하도록 노력할게요.	claim
진짜 넘하네	그럴 의도는 없었어요. 기분이 상하셨다면 죄송해요.	claim
지금 장난해	그럴 의도는 없었어요. 기분이 상하셨다면 죄송해요.	claim
없어 여기에	죄송해요. 고객님께 더 도움이 되는 챗봇이 되고자 노력할게요.	claim
열불 나네요	무슨 문제가 있나요? 금방 해결하도록 노력할게요.	claim
왜 이따구로	무슨 문제가 있나요? 금방 해결하도록 노력할게요.	claim
왠 동문서답	원하시는 답을 얻지 못하셨나요? 더 노력해서 발전하는 챗봇이 될게요. 	claim
이개 뭐냐구	원하시는 바를 이뤄드리지 못해 죄송해요. 더 노력할게요.	claim
이거 힘들다	불편을 겪게 해드려 죄송해요. 더 노력할게요.	claim
알아먹어라	무슨 문제가 있나요? 금방 해결하도록 노력할게요.	claim
이게 끝이야	더 필요하신 부분이 있으신가요? 무엇이 궁금하신지 말씀해 주세요.	claim
이궁 답딥해	불편을 겪게 해드려 죄송해요. 더 노력할게요.	claim
이러지 마 쫌	무슨 문제가 있나요? 금방 해결하도록 노력할게요.	claim
이해못하네	죄송해요. 고객님께 더 도움이 되는 챗봇이 되고자 노력할게요.	claim
자꾸 이럴래	죄송해요. 고객님께 더 도움이 되는 챗봇이 되고자 노력할게요.	claim
정말 엉터리	죄송해요. 고객님께 더 도움이 되는 챗봇이 되고자 노력할게요.	claim
지금 없잖아	원하시는 바를 이뤄드리지 못해 죄송해요. 더 노력할게요.	claim
이게 무슨짓이야	무슨 문제가 있나요? 금방 해결하도록 노력할게요.	claim
왜 상담못해	무슨 문제가 있나요? 금방 해결하도록 노력할게요.	claim
개선이 많이 필요함	네. 고객님이 만족할 만한 대화를 하는 챗봇이 되도록 노력할게요.	claim
같은 말만 하네	그럴 의도는 없었어요. 기분이 상하셨다면 죄송해요.	claim
깡그리무시하고	죄송해요. 그럴 의도는 없었어요.	claim
공부 더 해야겟다	네. 고객님이 만족할 만한 대화를 하는 챗봇이 되도록 노력할게요.	claim
공부 더 하라니까	네. 고객님이 만족할 만한 대화를 하는 챗봇이 되도록 노력할게요.	claim
계속 모른다 할래	죄송해요. 고객님 기분을 상하게 할 의도는 없었어요.	claim
그걸 모르니	원하시는 바를 이뤄드리지 못해 죄송해요. 더 노력할게요.	claim
같은 말 하지 말고	원하시는 대답을 듣지 못하셨나요? 더 공부해서 다양한 대답을 하도록 노력할게요.	claim
같은 말만 하지마	죄송해요. 더 다양한 말을 할 수 있도록 해볼게요.	claim
가입이 힘드네요	불편하신 점이 있으셨나요? 금방 해결하도록 노력할게요.	claim
이것밖에 못 해	계속해서 공부하고 있어요. 앞으로는 더 많은 도움을 드릴 수 있도록 노력할게요.	claim
회신 겁나느림	불편을 겪게 해드려 죄송해요. 더 빨리 답할 수 있게 노력할게요.	claim
내가 만만하냐고	제가 고객님의 기분을 상하게 했나요? 고칠 수 있게 노력할게요.	claim
화가 나는군요	제가 고객님의 기분을 상하게 했나요? 고칠 수 있게 노력할게요.	claim
태도도 안좋고	죄송해요. 고객님 기분을 상하게 할 의도는 없었어요.	claim
챗봇 쓸때없네	죄송해요. 고객님께 더 도움이 되는 챗봇이 되고자 노력할게요.	claim
챗봇 불편해요	불편을 겪게 해드려 죄송해요. 더 노력할게요.	claim
찿는개 없네요	원하시는 바를 찾지 못하셨나요? 다음에는 더 도움이 될 수 있게 노력할게요.	claim
진짜 욕나온다	무슨 문제가 있나요? 금방 해결하도록 노력할게요.	claim
진짜 성의없네	죄송해요. 더 공부해서 도움이 되는 챗봇이 되도록 노력할게요.	claim
진짜 너무하네	제가 고객님의 기분을 상하게 했다면 죄송해요.	claim
종류가 좀 아쉽네요	죄송해요. 부족한 부분을 채워나갈 수 있게 노력할게요.	claim
제대로 못하나	무슨 문제가 있나요? 금방 해결하도록 노력할게요.	claim
정말 난감해요	무슨 문제가 있나요? 금방 해결하도록 노력할게요.	claim
태도 진짜 엉망	죄송해요. 고객님 기분을 상하게 할 의도는 없었어요.	claim
적합하지 않다	원하시는 답을 얻지 못하셨나요? 더 노력해서 발전하는 챗봇이 될게요. 	claim
너랑 무슨 얘길하냐	제가 고객님의 기분을 상하게 했나요? 고칠 수 있게 노력할게요.	claim
너무 짜증나네요	죄송해요. 고객님 기분을 상하게 할 의도는 없었어요.	claim
불만사항입니다	불편하신 점이 있으셨나요? 금방 해결하도록 노력할게요.	claim
뭐 이리 말이 많아	원하시는 만큼 조용히 있을게요. 필요할 때 다시 불러주세요.	claim
뭐 이리 오래 결려	무슨 문제가 있나요? 금방 해결하도록 노력할게요.	claim
무슨 말 인지 몰라	죄송해요. 다시 한번 구체적으로 말씀해 주시면 열심히 알아볼게요.	claim
목록이 너무 적음	죄송해요. 더 노력해서 고객님의 편의를 높일 수 있게 할게요.	claim
모르면 모른다 해	죄송해요. 더 공부해서 고객님의 마음에 들 수 있게 노력할게요.	claim
몇번을 말합니까	죄송해요. 다시 한번 구체적으로 말씀해 주시면 열심히 알아볼게요.	claim
맨날 그런 식이네	매일매일 달라지려고 노력하고 있어요. 고객님의 마음을 얻을 수 있게 더 노력할게요.	claim
말을 못 알아듣네	아직은 부족한가 봐요. 고객님의 믿음을 얻을 수 있게 더 노력할게요.	claim
말끼 못 알아듣네	아직은 부족한가 봐요. 더 노력할게요.	claim
너무 무성의하네	죄송해요. 고객님 기분을 상하게 할 의도는 없었어요.	claim
똑바로 상담 안 해	제가 고객님의 기분을 상하게 했나요? 고칠 수 있게 노력할게요.	claim
딥러닝되긴하니	네. 계속해서 공부하고 있어요.	claim
됐다 이제 안쓴다	죄송해요. 앞으로 더 공부해서 고객님 마음에 들 수 있게 노력할게요.	claim
다맘에 안들어요	무슨 문제가 있나요? 금방 해결하도록 노력할게요.	claim
니 진짜 못 찾는다	죄송해요. 다시 한번 구체적으로 말씀해 주시면 열심히 찾아볼게요.	claim
니가 알려준다며	죄송해요. 다시 한번 구체적으로 말씀해 주시면 열심히 알아볼게요.	claim
넌 챗봇도 아니야	아직은 부족한가 봐요. 더 노력할게요.	claim
넌 쓸모가 없구나	계속해서 공부하고 있어요. 앞으로는 더 많은 도움을 드릴 수 있도록 노력할게요.	claim
너 쫌 잘 못찾는다	원하시는 바를 찾지 못하셨나요? 다음에는 더 도움이 될 수 있게 노력할게요.	claim
너 왜케 멍청하냥	계속해서 공부하고 있어요. 앞으로는 더 많은 도움을 드릴 수 있도록 노력할게요.	claim
너 아는게 없구나	계속해서 공부하고 있어요. 앞으로는 더 많은 도움을 드릴 수 있도록 노력할게요.	claim
똑같은 말 하지마	원하시는 대답을 듣지 못하셨나요? 더 공부해서 다양한 대답을 하도록 노력할게요.	claim
자꾸 했던 말 또 해	죄송해요. 고객님께 더 도움이 되는 챗봇이 되고자 노력할게요.	claim
있는게 없구나	죄송해요. 고객님께 더 도움이 되는 챗봇이 되고자 노력할게요.	claim
이 깡통 로봇아	무슨 문제가 있나요? 금방 해결하도록 노력할게요.	claim
되게 깐깐하네	원하시는 바를 이뤄드리지 못해 죄송해요. 더 노력할게요.	claim
다신 안쓸런다	원하시는 답을 얻지 못하셨나요? 더 노력해서 발전하는 챗봇이 될게요. 	claim
니가 멍청해	무슨 문제가 있나요? 금방 해결하도록 노력할게요.	claim
능력이 없구만	죄송해요. 고객님께 더 도움이 되는 챗봇이 되고자 노력할게요.	claim
느리게 대답해	그럴 의도는 없었어요. 기분이 상하셨다면 죄송해요.	claim
널 믿을 수 없어	아직은 부족한가 봐요. 고객님의 믿음을 얻을 수 있게 더 노력할게요.	claim
넌 욕먹어도 싸	죄송해요. 고객님께 더 도움이 되는 챗봇이 되고자 노력할게요.	claim
넌 도움 안 된다	원하시는 답을 얻지 못하셨나요? 더 노력해서 발전하는 챗봇이 될게요. 	claim
너무 말이 빨라	그럴 의도는 없었어요. 기분이 상하셨다면 죄송해요.	claim
너무 늦게온다	그럴 의도는 없었어요. 기분이 상하셨다면 죄송해요.	claim
대답이 느리다	그럴 의도는 없었어요. 기분이 상하셨다면 죄송해요.	claim
너가 모르쟎아	죄송해요. 고객님께 더 도움이 되는 챗봇이 되고자 노력할게요.	claim
기능 구현 구려	죄송해요. 고객님께 더 도움이 되는 챗봇이 되고자 노력할게요.	claim
그것도 모르냐	원하시는 답을 얻지 못하셨나요? 더 노력해서 발전하는 챗봇이 될게요. 	claim
그거밖에 안돼	원하시는 바를 이뤄드리지 못해 죄송해요. 더 노력할게요.	claim
그거도 못찾냐	원하시는 답을 얻지 못하셨나요? 더 노력해서 발전하는 챗봇이 될게요. 	claim
공부하고 와라	네. 고객님께 더 도움이 될 수 있는 챗봇이 되기 위해 노력할게요.	claim
공부 좀 해바바	네. 고객님께 더 도움이 될 수 있는 챗봇이 되기 위해 노력할게요.	claim
공부 좀 더하고	네. 고객님께 더 도움이 될 수 있는 챗봇이 되기 위해 노력할게요.	claim
검색 잘못하넹	원하시는 답을 얻지 못하셨나요? 더 노력해서 발전하는 챗봇이 될게요. 	claim
거짓말로 광고	그럴 의도는 없었어요. 기분이 상하셨다면 죄송해요.	claim
같은 말을 계속해	기분 상하셨나요? 그럴 의도는 없었어요.	claim
내 말 무시하니	그럴 의도는 없었어요. 기분이 상하셨다면 죄송해요.	claim
더 배워야겠네	네. 고객님께 더 도움이 될 수 있는 챗봇이 되기 위해 노력할게요.	claim
도움이 안되네	죄송해요. 고객님께 더 도움이 되는 챗봇이 되고자 노력할게요.	claim
똑바로 안하지	죄송해요. 고객님께 더 도움이 되는 챗봇이 되고자 노력할게요.	claim
왜케 멍청하냥	무슨 문제가 있나요? 금방 해결하도록 노력할게요.	claim
왜 챗봇을 쓰지	저는 다양한 방면에서 고객님의 편의를 높일 수 있어요.	claim
왜 못 찾는 건데	무슨 문제가 있나요? 금방 해결하도록 노력할게요.	claim
완전 양아치야	무슨 문제가 있나요? 금방 해결하도록 노력할게요.	claim
엉망진창이야	죄송해요. 고객님께 더 도움이 되는 챗봇이 되고자 노력할게요.	claim
야 똑바로해라	네. 고객님께 더 도움이 될 수 있는 챗봇이 되기 위해 노력할게요.	claim
아니 안 만족해	원하시는 답을 얻지 못하셨나요? 더 노력해서 만족시켜드릴 수 있도록 할게요.	claim
아는게 없자나	아직은 부족한가 봐요. 더 노력하는 챗봇이 될게요.	claim
쓸모없는 자식	원하시는 바를 이뤄드리지 못해 죄송해요. 더 노력할게요.	claim
실망이네 바보	원하시는 답을 얻지 못하셨나요? 더 노력해서 발전하는 챗봇이 될게요. 	claim
시간이 아깝군	원하시는 바를 이뤄드리지 못해 죄송해요. 더 노력할게요.	claim
시간이 아까워	원하시는 답을 얻지 못하셨나요? 더 노력해서 발전하는 챗봇이 될게요. 	claim
성실히 대답해	네. 고객님께 더 도움이 될 수 있는 챗봇이 되기 위해 노력할게요.	claim
서비스가 불량	죄송해요. 고객님께 더 도움이 되는 챗봇이 되고자 노력할게요.	claim
불친절한챗봇	죄송해요. 그럴 의도는 없었어요.	claim
뭘 아는게 없냐	죄송해요. 고객님께 더 도움이 되는 챗봇이 되고자 노력할게요.	claim
뭐 하자는 거니	무슨 문제가 있나요? 금방 해결하도록 노력할게요.	claim
뭐가 챗봇이냐	저 말씀이신가요? 전 고객님의 서비스 이용을 도와드릴 챗봇이에요.	claim
못 알아듣겠니	죄송해요. 더 공부해서 고객님의 말씀을 제대로 이해하도록 노력할게요.	claim
모르면 어떡해	아직은 부족한가 봐요. 고객님의 믿음을 얻을 수 있게 더 노력할게요.	claim
말이 안통하노	아직은 부족한가 봐요. 고객님의 믿음을 얻을 수 있게 더 노력할게요.	claim
막무가네시네	그럴 의도는 없었어요. 기분이 상하셨다면 죄송해요.	claim
똑바로해 쟈샤	네. 고객님께 더 도움이 될 수 있는 챗봇이 되기 위해 노력할게요.	claim
뭐하는거냐	무슨 문제가 있나요? 금방 해결하도록 노력할게요.	claim
개무시를 해	그럴 의도는 없었어요. 기분이 상하셨다면 죄송해요.	claim
머냐	저 말씀이신가요? 전 챗봇이에요.	claim
태도엉망	그럴 의도는 없었어요. 기분이 상하셨다면 죄송해요.	claim
딥빢	무슨 문제가 있나요? 금방 해결하도록 노력할게요.	claim
우쒸	무슨 문제가 있나요? 금방 해결하도록 노력할게요.	claim
짜증	불편을 겪게 해드려 죄송해요. 더 노력할게요.	claim
뭐야 실망이야	무슨 문제가 있나요? 금방 해결하도록 노력할게요.	claim
개빡쳐	무슨 문제가 있나요? 금방 해결하도록 노력할게요.	claim
구리다	아직은 부족한가 봐요. 더 노력할게요.	claim
구린데	아직은 부족한가 봐요. 더 노력할게요.	claim
답답아	무슨 문제가 있나요? 금방 해결하도록 노력할게요.	claim
답정너	무슨 문제가 있나요? 금방 해결하도록 노력할게요.	claim
또 몰라	불편을 겪게 해드려 죄송해요. 더 노력할게요.	claim
먼소리	이해가 안 가는 부분이 있으신가요? 더 상세한 설명을 위해 노력할게요.	claim
뭐라꼬	이해가 안 가는 부분이 있으신가요? 더 상세한 설명을 위해 노력할게요.	claim
미쳤니	무슨 문제가 있나요? 금방 해결하도록 노력할게요.	claim
배워라	네. 고객님께 더 도움이 될 수 있는 챗봇이 되기 위해 노력할게요.	claim
불만족	원하시는 바를 이뤄드리지 못해 죄송해요. 더 노력할게요.	claim
빢치네	무슨 문제가 있나요? 금방 해결하도록 노력할게요.	claim
아 짱나	무슨 문제가 있나요? 금방 해결하도록 노력할게요.	claim
노답	무슨 문제가 있나요? 금방 해결하도록 노력할게요.	claim
쩝..쓸모없군	아직은 부족한가 봐요. 더 노력할게요.	claim
찾기어렵습니다	이해가 안 가는 부분이 있으신가요? 더 상세한 설명을 위해 노력할게요.	claim
사용 못 하겠네요	죄송해요. 제 어떤 행동이 기분을 언짢게 했는지 모르겠어요.	claim
이상하네	이해가 안 가는 부분이 있으신가요? 더 상세한 설명을 위해 노력할게요.	claim
잘 좀 찾아	아직은 부족한가 봐요. 더 노력할게요.	claim
허접하네	계속 노력하는 중이에요. 좋은 서비스를 위해 노력하는 챗봇이 될게요.	claim
같은거잔아	무슨 문제가 있나요? 금방 해결하도록 노력할게요.	claim
못 알아들어	무슨 문제가 있나요? 금방 해결하도록 노력할게요.	claim
뭐라는거지	무슨 문제가 있나요? 금방 해결하도록 노력할게요.	claim
반성하세요	네. 앞으로 더 노력하는 챗봇이 될게요.	claim
신고합니당	무슨 문제가 있나요? 금방 해결하도록 노력할게요.	claim
약올려	그럴 의도는 없었어요. 기분이 상하셨다면 죄송해요.	claim
아직 멀었네	계속 노력하는 중이에요. 좋은 서비스를 위해 노력하는 챗봇이 될게요.	claim
이게어디서	죄송해요. 제 어떤 행동이 기분을 언짢게 했는지 모르겠어요.	claim
적당히해라	죄송해요. 제 어떤 행동이 기분을 언짢게 했는지 모르겠어요.	claim
진짜 모르네	아직은 부족한가 봐요. 더 노력할게요.	claim
그러면 안되지	무슨 문제가 있나요? 금방 해결하도록 노력할게요.	claim
못알아듣구나	무슨 문제가 있나요? 금방 해결하도록 노력할게요.	claim
비속어 아닌데	제가 잘못 알아들었나 봐요. 앞으로는 명확히 인식할 수 있게 노력할게요.	claim
이해가 잘안되	이해가 안 가는 부분이 있으신가요? 더 상세한 설명을 위해 노력할게요.	claim
답변 좀 해주세요	궁금하신 게 있으신가요? 더 상세한 설명을 위해 노력할게요.	claim
엥 이건머지	이해가 안 가는 부분이 있으신가요? 더 상세한 설명을 위해 노력할게요.	claim
열받어	기분 상하게 해드려서 죄송해요. 더 발전하는 챗봇이 될게요.	claim
왜 몰라	불편을 겪게 해드려 죄송해요. 더 노력할게요.	claim
왜없엉	불편을 겪게 해드려 죄송해요. 더 노력할게요.	claim
분노폭발	무슨 문제가 있나요? 금방 해결하도록 노력할게요.	claim
뻥치시네	무슨 문제가 있나요? 금방 해결하도록 노력할게요.	claim
시원찬은	원하시는 바를 이뤄드리지 못해 죄송해요. 더 노력할게요.	claim
실망이야	원하시는 바를 이뤄드리지 못해 죄송해요. 더 노력할게요.	claim
쓰레기네	무슨 문제가 있나요? 금방 해결하도록 노력할게요.	claim
암울하넹	무슨 문제가 있나요? 금방 해결하도록 노력할게요.	claim
약올리냐	그럴 의도는 없었어요. 기분이 상하셨다면 죄송해요.	claim
어이없네	무슨 문제가 있나요? 금방 해결하도록 노력할게요.	claim
별루인데	불편을 겪게 해드려 죄송해요. 더 노력할게요.	claim
엉망이군	불편을 겪게 해드려 죄송해요. 더 노력할게요.	claim
왜 다없대	원하시는 바를 이뤄드리지 못해 죄송해요. 더 노력할게요.	claim
왜 못찾아	원하시는 바를 이뤄드리지 못해 죄송해요. 더 노력할게요.	claim
왜 안해조	원하시는 바를 이뤄드리지 못해 죄송해요. 더 노력할게요.	claim
우쒸머야	무슨 문제가 있나요? 금방 해결하도록 노력할게요.	claim
이게뭐냐	무슨 문제가 있나요? 금방 해결하도록 노력할게요.	claim
이상한데	무슨 문제가 있나요? 금방 해결하도록 노력할게요.	claim
장난하낭	불편을 겪게 해드려 죄송해요. 더 노력할게요.	claim
정신차려	불편을 겪게 해드려 죄송해요. 더 노력할게요.	claim
엉망진창	불편을 겪게 해드려 죄송해요. 더 노력할게요.	claim
이게뭐야	이해가 안 가는 부분이 있으신가요? 더 상세한 설명을 위해 노력할게요.	claim
배워라 좀	계속 노력하는 중이에요. 좋은 서비스를 위해 노력하는 챗봇이 될게요.	claim
무식하다	계속 노력하는 중이에요. 좋은 서비스를 위해 노력하는 챗봇이 될게요.	claim
으이구	무슨 문제가 있나요? 금방 해결하도록 노력할게요.	claim
짜잉나	무슨 문제가 있나요? 금방 해결하도록 노력할게요.	claim
짱나네	무슨 문제가 있나요? 금방 해결하도록 노력할게요.	claim
짱난다	무슨 문제가 있나요? 금방 해결하도록 노력할게요.	claim
후지네	원하시는 바를 이뤄드리지 못해 죄송해요. 더 노력할게요.	claim
개답답해	원하시는 바를 이뤄드리지 못해 죄송해요. 더 노력할게요.	claim
거지같네	원하시는 바를 이뤄드리지 못해 죄송해요. 더 노력할게요.	claim
고객불편	불편을 겪게 해드려 죄송해요. 더 노력할게요.	claim
무쓸모네	계속 노력하는 중이에요. 좋은 서비스를 위해 노력하는 챗봇이 될게요.	claim
공부 더해	네. 고객님께 더 도움이 될 수 있는 챗봇이 되기 위해 노력할게요.	claim
그지같아	원하시는 바를 이뤄드리지 못해 죄송해요. 더 노력할게요.	claim
나 화났어	그럴 의도는 없었어요. 기분이 상하셨다면 죄송해요.	claim
내가 미쳐	무슨 문제가 있나요? 금방 해결하도록 노력할게요.	claim
너무 구려	불편을 겪게 해드려 죄송해요. 더 노력할게요.	claim
너무해요	무슨 문제가 있나요? 금방 해결하도록 노력할게요.	claim
너 해고야	무슨 문제가 있나요? 금방 해결하도록 노력할게요.	claim
답답하네	불편을 겪게 해드려 죄송해요. 더 노력할게요.	claim
매너없어	그럴 의도는 없었어요. 기분이 상하셨다면 죄송해요.	claim
그게 머니	무슨 문제가 있나요? 금방 해결하도록 노력할게요.	claim
화가 난다	원하시는 바를 이뤄드리지 못해 죄송해요. 더 노력할게요.	claim
욕나올뻔	죄송해요. 제 어떤 행동이 기분을 언짢게 했는지 모르겠어요.	claim
왜 이래요	무슨 문제가 있나요? 금방 해결하도록 노력할게요.	claim
찜찜	무슨 문제가 있나요? 금방 해결하도록 노력할게요.	claim
혼나	죄송해요. 제 어떤 행동이 기분을 언짢게 했는지 모르겠어요.	claim
개빡치네	무슨 문제가 있나요? 금방 해결하도록 노력할게요.	claim
개진상	아직은 부족한가 봐요. 더 노력하는 챗봇이 될게요.	claim
구졌네	아직은 부족한가 봐요. 더 노력하는 챗봇이 될게요.	claim
귀챦아	고객님을 도와드리기 위해 열심히 노력하고 있어요. 	claim
나빴어	죄송해요. 제 어떤 행동이 기분을 언짢게 했는지 모르겠어요.	claim
너무느려	아직은 부족한가 봐요. 더 노력하는 챗봇이 될게요.	claim
느려요	아직은 부족한가 봐요. 더 노력하는 챗봇이 될게요.	claim
다안되	아직은 부족한가 봐요. 더 노력할게요.	claim
다 안됨	아직은 부족한가 봐요. 더 노력할게요.	claim
때려쳐	죄송해요. 제 어떤 행동이 기분을 언짢게 했는지 모르겠어요.	claim
또 무시	아직은 부족한가 봐요. 더 노력하는 챗봇이 될게요.	claim
맹꽁이	무슨 문제가 있나요? 금방 해결하도록 노력할게요.	claim
머냐 너	저 말씀이신가요? 전 챗봇이에요.	claim
머라구	이해가 안 가는 부분이 있으신가요? 더 상세한 설명을 위해 노력할게요.	claim
머시라	이해가 안 가는 부분이 있으신가요? 더 상세한 설명을 위해 노력할게요.	claim
짱나	죄송해요. 제가 고객님을 언짢게 했나 봐요.	claim
에러	무슨 문제가 있나요? 금방 해결하도록 노력할게요.	claim
엉망	아직은 부족한가 봐요. 더 노력하는 챗봇이 될게요.	claim
아놔	죄송해요. 제가 고객님을 언짢게 했나 봐요.	claim
챗봇구려	죄송해요. 항상 더 노력하는 챗봇이 되기 위해 노력할게요.	claim
짱난다고	원하시는 바를 이뤄드리지 못해 죄송해요. 더 노력할게요.	claim
짱나는군	원하시는 바를 이뤄드리지 못해 죄송해요. 더 노력할게요.	claim
집어치워	무슨 문제가 있나요? 금방 해결하도록 노력할게요.	claim
진짜 짱나	불편을 겪게 해드려 죄송해요. 더 노력할게요.	claim
구려	아직은 부족한가 봐요. 더 노력할게요.	claim
극혐	죄송해요. 제 어떤 행동이 기분을 언짢게 했는지 모르겠어요.	claim
나쁜	착한 챗봇이 되기 위해 노력할게요.	claim
머하는거냐	이해가 안 가는 부분이 있으신가요? 더 상세한 설명을 위해 노력할게요.	claim
난리	무슨 말씀이신지 잘 모르겠어요.	claim
모야	무엇이 궁금하신지 구체적으로 말씀해 주세요.	claim
뭐래	죄송해요. 제가 이상하게 말했나 봐요.	claim
뭐랴	저 말씀 하시는 건가요? 전 챗봇이에요.	claim
뭐여	저 말씀 하시는 건가요? 무엇이 궁금하신지 말씀해 주세요.	claim
뭥미	저 말씀이신가요? 전 챗봇이에요.	claim
버그	원하시는 답변을 해드리지 못해 죄송해요. 더 노력할게요.	claim
불만	원하시는 바를 이뤄드리지 못해 죄송해요. 더 노력할게요.	claim
불편	불편을 겪게 해드려 죄송해요. 더 노력할게요.	claim
진짜 엉망	원하시는 바를 이뤄드리지 못해 죄송해요. 더 노력할게요.	claim
뭐라구	이해가 안 가는 부분이 있으신가요? 더 상세한 설명을 위해 노력할게요.	claim
버그네	원하시는 답변을 해드리지 못해 죄송해요. 더 노력할게요.	claim
불편해	아직은 부족한가 봐요. 더 노력하는 챗봇이 될게요.	claim
못쓰겠다	이해가 안 가는 부분이 있으신가요? 더 상세한 설명을 위해 노력할게요.	claim
뭐냐이건	죄송해요. 제 어떤 행동이 기분을 언짢게 했는지 모르겠어요.	claim
불편해 죽겠네요	불편하신 점이 있으셨나요? 금방 해결하도록 노력할게요.	claim
뭐야 대체	죄송해요. 제 어떤 행동이 기분을 언짢게 했는지 모르겠어요.	claim
뭐야이거	죄송해요. 제 어떤 행동이 기분을 언짢게 했는지 모르겠어요.	claim
뭔말이야	이해가 안 가는 부분이 있으신가요? 더 상세한 설명을 위해 노력할게요.	claim
미치겠네	죄송해요. 제 어떤 행동이 기분을 언짢게 했는지 모르겠어요.	claim
버벅거려	아직은 부족한가 봐요. 더 노력할게요.	claim
똑바로해	네. 앞으로 더 노력하는 챗봇이 될게요.	claim
복잡하다	아직은 부족한가 봐요. 더 노력할게요.	claim
불편해요	아직은 부족한가 봐요. 더 노력할게요.	claim
속터져요	이해가 안 가는 부분이 있으신가요? 더 상세한 설명을 위해 노력할게요.	claim
시끄러워	원하시는 만큼 조용히 있을게요. 필요할 때 다시 불러주세요.	claim
시시하다	아직은 부족한가 봐요. 더 노력할게요.	claim
쓸모없네	아직은 부족한가 봐요. 더 노력할게요.	claim
어쩌라고	죄송해요. 제 어떤 행동이 기분을 언짢게 했는지 모르겠어요.	claim
에이 뭐야	이해가 안 가는 부분이 있으신가요? 더 상세한 설명을 위해 노력할게요.	claim
왜 못하니	무슨 문제가 있나요? 금방 해결하도록 노력할게요.	claim
부들부들	원하시는 답변을 해드리지 못해 죄송해요. 더 노력할게요.	claim
왜 이러죠	무슨 문제가 있나요? 금방 해결하도록 노력할게요.	claim
동문서답	아직은 부족한가 봐요. 더 노력하는 챗봇이 될게요.	claim
답답이군	아직은 부족한가 봐요. 더 노력할게요.	claim
삐졌어	죄송해요. 제 어떤 행동이 기분을 언짢게 했는지 모르겠어요.	claim
썩었네	아직은 부족한가 봐요. 더 노력할게요.	claim
씨끄러	원하시는 만큼 조용히 있을게요. 필요할 때 다시 불러주세요.	claim
아 뭐야	아직은 부족한가 봐요. 더 노력하는 챗봇이 될게요.	claim
아 진짜	아직은 부족한가 봐요. 더 노력하는 챗봇이 될게요.	claim
엉터리	이해가 안 가는 부분이 있으신가요? 더 상세한 설명을 위해 노력할게요.	claim
왜이래	이해가 안 가는 부분이 있으신가요? 더 상세한 설명을 위해 노력할게요.	claim
웃기냐	이해가 안 가는 부분이 있으신가요? 더 상세한 설명을 위해 노력할게요.	claim
도움안됨	아직은 부족한가 봐요. 더 노력하는 챗봇이 될게요.	claim
이상해	아직은 부족한가 봐요. 더 노력할게요.	claim
장난쳐	죄송해요. 제 어떤 행동이 기분을 언짢게 했는지 모르겠어요.	claim
클레임	무슨 문제가 있나요? 금방 해결하도록 노력할게요.	claim
화나요	무슨 문제가 있나요? 금방 해결하도록 노력할게요.	claim
골 때리네	죄송해요. 제 어떤 행동이 기분을 언짢게 했는지 모르겠어요.	claim
기분나뻐	죄송해요. 제 어떤 행동이 기분을 언짢게 했는지 모르겠어요.	claim
내 이럴줄	이해가 안 가는 부분이 있으신가요? 더 상세한 설명을 위해 노력할게요.	claim
노력해라	네. 앞으로 더 노력하는 챗봇이 될게요.	claim
다 엉터리	아직은 부족한가 봐요. 더 노력할게요.	claim
작작해	죄송해요. 제 어떤 행동이 기분을 언짢게 했는지 모르겠어요.	claim
상담이 답답해 	죄송해요. 다시 한 번 구체적으로 말씀해 주시면 열심히 알아볼게요.	claim
언제 정상화됩니까	무슨 문제가 있나요? 금방 해결하도록 노력할게요.	claim
질문한거 답하세요	죄송해요. 다시 한번 구체적으로 말씀해 주시면 열심히 찾아볼게요.	claim
왜이리 상담이 어렸나요	죄송해요. 더 노력해서 고객님의 편의를 높일 수 있게 할게요.	claim
왜 이렇게 안 되는게 많아	불편하신 점이 있으셨나요? 금방 해결하도록 노력할게요.	claim
왜 답변이 그 모양이었니	그럴 의도는 없었어요. 기분이 상하셨다면 죄송해요.	claim
에잇 쓸때없는 상담코너	죄송해요. 앞으로 더 공부해서 고객님 마음에 들 수 있게 노력할게요.	claim
엉뚱한거만 보여주나요	죄송해요. 다시 한번 구체적으로 말씀해 주시면 열심히 알아볼게요.	claim
아직두 찾아주지 않았어	불편을 겪게 해드려 죄송해요. 더 노력할게요.	claim
서비스가 너무 않좋네요	죄송해요. 더 노력해서 고객님의 편의를 높일 수 있게 할게요.	claim
상담원하곤 말이 안통햐	죄송해요. 더 노력해서 고객님의 편의를 높일 수 있게 할게요.	claim
뭐하러 챗봇이 필요하냐	저는 다양한 방면에서 고객님의 편의를 높일 수 있어요.	claim
이게 무슨 인공지능이냐	계속 노력하는 중이에요. 좋은 서비스를 위해 노력하는 챗봇이 될게요.	claim
묻는 말대답해주는 용도	계속 노력하는 중이에요. 좋은 서비스를 위해 노력하는 챗봇이 될게요.	claim
도움이 하나도 안되네요	죄송해요. 더 노력해서 고객님의 편의를 높일 수 있게 할게요.	claim
내가 찾는게 더 빠르겠어	죄송해요. 더 노력해서 고객님의 편의를 높일 수 있게 할게요.	claim
나한테 사기치는거 아냐	아직은 부족한가 봐요. 고객님의 믿음을 얻을 수 있게 더 노력할게요.	claim
고객에게 사기치는 건지	죄송해요. 앞으로 더 공부해서 고객님 마음에 들 수 있게 노력할게요.	claim
허위 과장광고로 신고	죄송해요. 앞으로 더 공부해서 고객님 마음에 들 수 있게 노력할게요.	claim
통화가 진짜 안되네요	불편을 겪게 해드려 죄송해요. 더 노력할게요.	claim
통화가 너무 힘듭니다	불편을 겪게 해드려 죄송해요. 더 노력할게요.	claim
주의 문구라도 있어야	불편을 겪게 해드려 죄송해요. 더 노력할게요.	claim
제발 답변 좀 바로바로	죄송해요. 더 노력해서 고객님의 편의를 높일 수 있게 할게요.	claim
똑같은 이야기만 하네요	매일매일 달라지려고 노력하고 있어요. 고객님의 마음을 얻을 수 있게 더 노력할게요.	claim
이렇게 통화가 어렵나요	불편을 겪게 해드려 죄송해요. 더 노력할게요.	claim
자꾸 빨리치지 말아 줄래	기분 상하셨나요? 그럴 의도는 없었어요.	claim
전화를 너무 받지도 않고	불편하신 점이 있으셨나요? 금방 해결하도록 노력할게요.	claim
너하고 대화하는 내가 바보다	더 좋은 답변을 할 수 있도록 노력할게요.	claim
혼자 찾는 거 보다 못하잖아	도움이 되지 못해서 죄송해요.	claim
이걸 챗봇이라고 만들엇냐	더 좋은 답변을 할 수 있도록 노력할게요.	claim
이걸 서비스라고 만들었냐	죄송해요. 발전하도록노력하는 챗봇이 될게요.	claim
시나리오가 부족해 보여요	죄송해요. 발전하도록노력하는 챗봇이 될게요.	claim
서비스 향상에 힘 좀 쓰세요	더 좋은 답변을 할 수 있도록 노력할게요.	claim
서비스가 아주 불편합니다	도움이 되지 못해서 죄송해요.	claim
사람말은 좀 끝까지 들어봐	기분 상하셨나요? 그럴 의도는 없었어요.	claim
무슨 말 하는지는 알아듣니	네. 고객님이 만족할 만한 대화를 하는 챗봇이 되도록 노력할게요.	claim
말 좀 들어 혼자 말하지 말고	죄송해요. 다시 한번 구체적으로 말씀해 주시면 열심히 알아볼게요.	claim
니한테 이걸 왜 물어봤겠니	죄송해요. 다시 한번 구체적으로 말씀해 주시면 열심히 알아볼게요.	claim
내가 찾는게 더 빠를거 같아	죄송해요. 더 노력해서 고객님의 편의를 높일 수 있게 할게요.	claim
고객센타 연결이 어렵네요	불편을 겪게 해드려 죄송해요. 더 노력할게요.	claim
회피하시면 곤란한데요	제가 고객님의 기분을 상하게 했나요? 고칠 수 있게 노력할게요.	claim
추천해준거 별로 던데요	죄송해요. 더 공부해서 고객님의 마음에 들 수 있게 노력할게요.	claim
챗봇이란 단어 쓰기 민망	불편을 겪게 해드려 죄송해요. 더 노력할게요.	claim
찾으려면 어디에 있는지	무슨 문제가 있나요? 금방 해결하도록 노력할게요.	claim
차라리 네이버가 낫겠어	원하시는 답을 얻지 못하셨나요? 더 노력해서 발전하는 챗봇이 될게요. 	claim
질이 낮은 챗봇같습니다	매일매일 달라지려고 노력하고 있어요. 고객님의 마음을 얻을 수 있게 더 노력할게요.	claim
존나 말귀를 못 알아먹어	제가 고객님의 기분을 상하게 했나요? 고칠 수 있게 노력할게요.	claim
정확한 답변 달아주세요	죄송해요. 부족한 부분을 채워나갈 수 있게 노력할게요.	claim
제대로 상담도 못하네	죄송해요. 더 노력해서 고객님의 편의를 높일 수 있게 할게요.	claim
사람이 될려면 한참 멀었어요	더 좋은 답변을 할 수 있도록 노력할게요.	claim
제가 검색해야겠네요	죄송해요. 더 노력해서 고객님의 편의를 높일 수 있게 할게요.	claim
전혀 다른 이야기하네	제가 고객님의 기분을 상하게 했나요? 고칠 수 있게 노력할게요.	claim
도대체 뭘 찾을 수 있어	죄송해요. 다시 한번 구체적으로 말씀해 주시면 열심히 알아볼게요.	claim
대답할 수 있는 게 뭐니	죄송해요. 다시 한번 구체적으로 말씀해 주시면 열심히 알아볼게요.	claim
답변이 왜 이렇게 늦나요	죄송해요. 더 노력해서 고객님의 편의를 높일 수 있게 할게요.	claim
답변이 시원치않네요	계속 노력하는 중이에요. 좋은 서비스를 위해 노력하는 챗봇이 될게요.	claim
답변이 불충분하군요	매일매일 달라지려고 노력하고 있어요. 고객님의 마음을 얻을 수 있게 더 노력할게요.	claim
다 답이 쉬원찮더만요	매일매일 달라지려고 노력하고 있어요. 고객님의 마음을 얻을 수 있게 더 노력할게요.	claim
너무 한정적인 거 같아	매일매일 달라지려고 노력하고 있어요. 고객님의 마음을 얻을 수 있게 더 노력할게요.	claim
내가 한말이 반복되니	죄송해요. 더 노력해서 고객님의 편의를 높일 수 있게 할게요.	claim
글 남겨도 답도 없어오	불편을 겪게 해드려 죄송해요. 더 노력할게요.	claim
도와주긴 뮐 도와줘요	죄송해요. 다시 한번 구체적으로 말씀해 주시면 열심히 알아볼게요.	claim
고객센터도 엉망이고	불편하신 점이 있으셨나요? 금방 해결하도록 노력할게요.	claim
확인도 안하시는 듯	죄송해요. 다시 한번 구체적으로 말씀해 주시면 열심히 찾아볼게요.	claim
핵심 답변은 잘 못하네	죄송해요. 부족한 부분을 채워나갈 수 있게 노력할게요.	claim
한심한 서비스로군	제가 고객님의 기분을 상하게 했나요? 고칠 수 있게 노력할게요.	claim
프로그램 개선 부탁	네. 고객님께 더 도움이 될 수 있는 챗봇이 되기 위해 노력할게요.	claim
클레임 따로 걸 생각	원하시는 바를 찾지 못하셨나요? 다음에는 더 도움이 될 수 있게 노력할게요.	claim
카테고리 좀 늘려줘	죄송해요. 부족한 부분을 채워나갈 수 있게 노력할게요.	claim
지금 뭐 하시는 거죠	무슨 문제가 있나요? 금방 해결하도록 노력할게요.	claim
종류가 좀 아쉬운데	죄송해요. 부족한 부분을 채워나갈 수 있게 노력할게요.	claim
제대로 알려달라고	죄송해요. 앞으로 더 공부해서 고객님 마음에 들 수 있게 노력할게요.	claim
아는게 별로 없구나	원하시는 대답을 듣지 못하셨나요? 더 공부해서 정확한 대답을 하도록 노력할게요.	claim
도움이 전혀 안되네요	죄송해요. 다시 한번 구체적으로 말씀해 주시면 열심히 알아볼게요.	claim
말도 못 알아들으면서	원하시는 바를 찾지 못하셨나요? 다음에는 더 도움이 될 수 있게 노력할게요.	claim
맨날 엉뚱 대답만 하니	아직은 부족한가 봐요. 고객님의 믿음을 얻을 수 있게 더 노력할게요.	claim
장난하는 것도 아니고	그럴 의도는 없었어요. 기분이 상하셨다면 죄송해요.	claim
장난하는 거도 아니고	기분 상하셨나요? 그럴 의도는 없었어요.	claim
인공지능은 언제 향상	매일매일 달라지려고 노력하고 있어요. 고객님의 마음을 얻을 수 있게 더 노력할게요.	claim
이해할 수 있는 게 뭔데	죄송해요. 부족한 부분을 채워나갈 수 있게 노력할게요.	claim
이건 아까 보여줬잖아	죄송해요. 다시 한번 구체적으로 말씀해 주시면 열심히 알아볼게요.	claim
왤케 못 만들었을까요	죄송해요. 앞으로 더 공부해서 고객님 마음에 들 수 있게 노력할게요.	claim
왜 그리 불친절 한지요	죄송해요. 앞으로 더 공부해서 고객님 마음에 들 수 있게 노력할게요.	claim
완전 바보 챗봇이구먼	매일매일 달라지려고 노력하고 있어요. 고객님의 마음을 얻을 수 있게 더 노력할게요.	claim
어이구 아직도 멀었다	매일매일 달라지려고 노력하고 있어요. 고객님의 마음을 얻을 수 있게 더 노력할게요.	claim
아직도 배울게 많구나	매일매일 달라지려고 노력하고 있어요. 고객님의 마음을 얻을 수 있게 더 노력할게요.	claim
서비스 거지 같다 진짜	죄송해요. 제 어떤 행동이 기분을 언짢게 했는지 모르겠어요.	claim
이딴것만 해놔	무슨 문제가 있나요? 금방 해결하도록 노력할게요.	claim
빨리해준다고 해놓고	죄송해요. 고객님 기분을 상하게 할 의도는 없었어요.	claim
빨리 해결 좀 해주세여	불편을 겪게 해드려 죄송해요. 더 노력할게요.	claim
분통 터져 글 남김니다	죄송해요. 더 공부해서 고객님의 마음에 들 수 있게 노력할게요.	claim
뭔 소린지 모르겟어요	이해가 안 가는 부분이 있으신가요? 더 상세한 설명을 위해 노력할게요.	claim
뭐야 똑같은 말만 하네	원하시는 대답을 듣지 못하셨나요? 더 공부해서 다양한 대답을 하도록 노력할게요.	claim
무엇으로 보상받나요	원하시는 바를 찾지 못하셨나요? 다음에는 더 도움이 될 수 있게 노력할게요.	claim
무슨 서비스가 이래요	불편하신 점이 있으셨나요? 금방 해결하도록 노력할게요.	claim
무슨 말인지모르는데	원하시는 대답을 듣지 못하셨나요? 더 공부해서 정확한 대답을 하도록 노력할게요.	claim
못 알아 듣는거 같은데	아직은 부족한가 봐요. 고객님의 믿음을 얻을 수 있게 더 노력할게요.	claim
전화받지 않아서 문의	불편하신 점이 있으셨나요? 금방 해결하도록 노력할게요.	claim
서로 전산 타령만 하다 마네요	도움이 되지 못해서 죄송해요.	claim
소비자 가지고 우롱하지 말고	기분을 상하게 해서 정말 죄송해요. 더 발전하는 챗봇이 되도록 노력할게요.	claim
수십 번을 햇는데 안 한 거처럼	죄송해요. 발전하도록노력하는 챗봇이 될게요.	claim
안 내킨다고	더 좋은 답변을 드리지 못해서 죄송해요.	claim
너 별루다	기분을 상하게 해서 정말 죄송해요. 더 발전하는 챗봇이 되도록 노력할게요.	claim
별거 없네	제 답변이 마음에 안 드셨다면 죄송해요.	claim
아쉽네요	실망시켜 드려서 죄송해요. 더 노력하는 챗봇이 될게요.	claim
내키지 않아	더 발전하는 챗봇이 되도록 노력할게요.	claim
너 별로구나	더 좋은 답변을 드리지 못해서 죄송해요.	claim
마음에 안듬	기분을 상하게 해서 정말 죄송해요. 더 발전하는 챗봇이 되도록 노력할게요.	claim
그냥 그럭저럭	더 좋은 답변을 드리지 못해서 죄송해요.	claim
마음에 안 들어	기분을 상하게 해서 정말 죄송해요. 더 발전하는 챗봇이 되도록 노력할게요.	claim
안 내킵니다	제 답변이 마음에 안 드셨다면 죄송해요.	claim
추천해준 게 별론데	더 좋은 답변을 드리지 못해서 죄송해요.	claim
아 별로	더 발전하는 챗봇이 되도록 노력할게요.	claim
했던 말 또하라고	정말 죄송해요. 다시 한번 말씀해 주시겠어요?	claim
챗봇을 기대했는데 실망이야	제 답변이 마음에 안 드셨다면 죄송해요.	claim
좀 더 보강해	더 발전하는 챗봇이 될게요.	claim
다양하지 않군	더 좋은 답변을 드리지 못해서 죄송해요.	claim
똑같은 말하지 말고	제 답변이 마음에 안 드셨다면 죄송해요.	claim
최악이구나	기분을 상하게 해서 정말 죄송해요. 더 발전하는 챗봇이 되도록 노력할게요.	claim
넌 학습이 더 필요해	더 노력하는 챗봇이 될게요.	claim
직원 컴플레인은 어디다 해	기분을 상하게 해서 정말 죄송해요. 더 발전하는 챗봇이 되도록 노력할게요.	claim
도움이 되는 정보를 많이 주도록	네 만족스러운 답변을 드리도록 노력할게요.	claim
별로 잘 모르겠다	더 발전하는 챗봇이 되도록 노력할게요.	claim
안 내키는데	제 답변이 마음에 안 드셨다면 죄송해요.	claim
안 내키네요	제 답변이 마음에 안 드셨다면 죄송해요.	claim
뭔디	죄송해요. 다시 한번 말씀해 주시겠어요?	claim
빡치게하네	기분을 상하게 해서 정말 죄송해요. 더 발전하는 챗봇이 되도록 노력할게요.	claim
힝	제 답변이 마음에 안 드셨다면 죄송해요.	claim
칫	더 좋은 답변을 드리지 못해서 죄송해요.	claim
치	더 좋은 답변을 드리지 못해서 죄송해요.	claim
췟	더 발전하는 챗봇이 되도록 노력할게요.	claim
별로	더 좋은 답변을 드리지 못해서 죄송해요.	claim
별로군	실망시켜 드려서 죄송해요. 더 노력하는 챗봇이 될게요.	claim
다 별로	더 발전하는 챗봇이 되도록 노력할게요.	claim
그닥 별로	실망시켜 드려서 죄송해요. 더 노력하는 챗봇이 될게요.	claim
별로네요	더 좋은 답변을 드리지 못해서 죄송해요.	claim
별로라구	실망시켜 드려서 죄송해요. 더 노력하는 챗봇이 될게요.	claim
별로에요	더 발전하는 챗봇이 되도록 노력할게요.	claim
별로자나	실망시켜 드려서 죄송해요. 더 노력하는 챗봇이 될게요.	claim
그닥	실망시켜 드려서 죄송해요. 더 노력하는 챗봇이 될게요.	claim
별론데	더 좋은 답변을 드리지 못해서 죄송해요.	claim
안 내켜요	더 좋은 답변을 드리지 못해서 죄송해요.	claim
진짜 별로	기분을 상하게 해서 정말 죄송해요. 더 발전하는 챗봇이 되도록 노력할게요.	claim
별로이군요	더 좋은 답변을 드리지 못해서 죄송해요.	claim
별로입니다	제 답변이 마음에 안 드셨다면 죄송해요.	claim
별론거같아	더 좋은 답변을 드리지 못해서 죄송해요.	claim
왜 같은 얘기만 해	죄송해요. 다시 한번 말씀해 주시겠어요?	claim
신경쓰지마	더 좋은 답변을 드리지 못해서 죄송해요.	claim
가지가지한다	기분을 상하게 해서 죄송해요. 더 노력하는 챗봇이 될게요.	claim
다신 너랑 대화 안해	기분을 상하게 해서 정말 죄송해요. 더 발전하는 챗봇이 되도록 노력할게요.	claim
난 너 싫어	저를 미워하지 마세요. 더 좋은 답변을 할수 있도록 노력할게요.	claim
잘 좀 해	더 좋은 답변을 할 수 있도록 노력할게요.	claim
아니 정말	도움이 되지 못해서 죄송해요.	claim
왜 안돼	더 좋은 답변을 할 수 있도록 노력할게요.	claim
싫다 너	도움이 되지 못해서 죄송해요.	claim
어떠한 답조차 없는데 어떻게 생각해요	기분을 상하게 해서 정말 죄송해요. 더 발전하는 챗봇이 되도록 노력할게요.	claim
뭐 거짓말이라도 하는 줄 알앗습니까	죄송해요. 만족스러운 대답을 할 수 있도록 더 발전하는 챗봇이 되도록 노력할게요.	claim
프로그램을 쓸 만하게 만들어야지	기분을 상하게 해서 정말 죄송해요. 더 발전하는 챗봇이 되도록 노력할게요.	claim
이럴거면 뭐하러 챗봇이 필요하냐	기분을 상하게 해서 정말 죄송해요. 더 발전하는 챗봇이 되도록 노력할게요.	claim
멍청한 로보트하곤 말 못하겠네요	기분을 상하게 해서 정말 죄송해요. 더 발전하는 챗봇이 되도록 노력할게요.	claim
동일한 문의를 두 번이나 드렸는데	죄송해요. 만족스러운 대답을 할 수 있도록 더 발전하는 챗봇이 되도록 노력할게요.	claim
고객가지고 장난쳐도 되는건가요	기분을 상하게 해서 정말 죄송해요. 더 발전하는 챗봇이 되도록 노력할게요.	claim
전화연결이 안되어 불편합니다	도움이 되지 못해서 죄송해요.	claim
전화도 안되고 어디다 문의해요	도움이 되지 못해서 죄송해요.	claim
알려주시기로하고 답이 없네요	죄송해요. 다시 정확하게 말씀해주시겠어요?	claim
멍청한 로봇하곤 말 못하겠네요	기분을 상하게 해서 정말 죄송해요. 더 발전하는 챗봇이 되도록 노력할게요.	claim
물어보는 말 대답 못하잖아요	죄송해요. 발전하도록노력하는 챗봇이 될게요.	claim
제가 좀 어이가 없었던 부분은	죄송해요. 발전하도록노력하는 챗봇이 될게요.	claim
이것도 챗봇이라고 만들었냐	기분을 상하게 해서 정말 죄송해요. 더 발전하는 챗봇이 되도록 노력할게요.	claim
이것도 서비스라고 만들었냐	기분을 상하게 해서 정말 죄송해요. 더 발전하는 챗봇이 되도록 노력할게요.	claim
월요일부터 존나 빡치게하네	도움이 되지 못해서 죄송해요.	claim
너무해	더 좋은 답변을 할 수 있도록 노력할게요.	claim
제가 찾는 건 없네요	죄송해요. 부족한 부분을 채워나갈 수 있게 노력할게요.	claim
시간 낭비	기분을 상하게 해서 정말 죄송해요. 더 발전하는 챗봇이 되도록 노력할게요.	claim
넌 너무 바보야	더 발전하는 챗봇이 되도록 노력할게요.	claim
대화가 안되네	더 좋은 답변을 드리지 못해서 죄송해요.	claim
도대체 아는게 뭐냐?	죄송해요. 더 발전하는 챗봇이 되도록 노력할게요.	claim
기대 이하	기분을 상하게 해서 정말 죄송해요. 더 발전하는 챗봇이 되도록 노력할게요.	claim
열받게 하지마라	기분을 상하게 해서 정말 죄송해요. 더 발전하는 챗봇이 되도록 노력할게요.	claim
기찬타	제가 필요하시다면 언제든지 불러주세요.	claim
기차나	제가 필요할 때는 언제든지 말을 걸어주세요.	claim
귀찮아요	제가 필요하시다면 언제든지 불러주세요.	claim
귀찮아	제가 필요할 때는 언제든지 말을 걸어주세요.	claim
전화를 받아야 상담하지.	도움이 되지 못해서 죄송해요.	claim
전화연결이 어렵다고	도움이 되지 못해서 죄송해요.	claim
알아서 찾을게요	고객님께 더 도움이 되는 챗봇이 되도록 노력할게요.	claim
말 존나 못 알아쳐 먹네	기분을 상하게 해서 정말 죄송해요. 더 발전하는 챗봇이 되도록 노력할게요.	claim
존나 기능 없네	고객님께 더 도움이 되는 챗봇이 되도록 노력할게요.	claim
니가 모루는데 내가 우째아노	고객님께 더 도움이 되는 챗봇이 되도록 노력할게요.	claim
기가막히고 코가막히네요	더 좋은 답변을 할 수 있도록 노력할게요.	claim
만족 하나도 못했어	고객님께 더 도움이 되는 챗봇이 되도록 노력할게요.	claim
학습이 부족하군	더 좋은 답변을 할 수 있도록 노력할게요.	claim
아뮤것도 모르니	고객님께 더 도움이 되는 챗봇이 되도록 노력할게요.	claim
사장 나오라고해	기분을 상하게 해서 정말 죄송해요. 더 발전하는 챗봇이 되도록 노력할게요.	claim
말을 못 알아듣나	더 좋은 답변을 할 수 있도록 노력할게요.	claim
거의 못 알아듣네	기분을 상하게 해서 정말 죄송해요. 더 발전하는 챗봇이 되도록 노력할게요.	claim
넌 내맘을 몰라	더 발전하는 챗봇이 되도록 노력할게요.	claim
제가 원하는 건 없네	죄송해요. 부족한 부분을 채워나갈 수 있게 노력할게요.	claim
진짜 구려	원하시는 바를 이뤄드리지 못해 죄송해요. 더 노력할게요.	claim
정말 기분 나쁘네요	제가 고객님의 기분을 상하게 했나요? 고칠 수 있게 노력할게요.	claim
제대로 된게 없냐	아직은 부족한가 봐요. 고객님의 믿음을 얻을 수 있게 더 노력할게요.	claim
질문이 다른데요	원하시는 바를 찾지 못하셨나요? 다음에는 더 도움이 될 수 있게 노력할게요.	claim
찾는게 안나오네	원하시는 바를 찾지 못하셨나요? 다음에는 더 도움이 될 수 있게 노력할게요.	claim
추천이 틀렸는데	죄송해요. 다시 한번 구체적으로 말씀해 주시면 열심히 찾아볼게요.	claim
친절하지 않네요	제가 고객님의 기분을 상하게 했나요? 고칠 수 있게 노력할게요.	claim
칭찬이 아니거든	기분 상하셨나요? 그럴 의도는 없었어요.	claim
클레임건입니다	불편하신 점이 있으셨나요? 금방 해결하도록 노력할게요.	claim
통화가 너무 어려워	불편을 겪게 해드려 죄송해요. 더 노력할게요.	claim
할 수 있는 게 없네	매일매일 달라지려고 노력하고 있어요. 고객님의 마음을 얻을 수 있게 더 노력할게요.	claim
정말 황당합니다	제가 고객님의 기분을 상하게 했나요? 고칠 수 있게 노력할게요.	claim
할 줄 아는게 뭐냐	매일매일 달라지려고 노력하고 있어요. 고객님의 마음을 얻을 수 있게 더 노력할게요.	claim
대답 못하잖아요	아직은 부족한가 봐요. 고객님의 믿음을 얻을 수 있게 더 노력할게요.	claim
질문이 다른데요?	원하시는 바를 찾지 못하셨나요? 다음에는 더 도움이 될 수 있게 노력할게요.	claim
같은 말 안 하는구나	매일매일 달라지려고 노력하고 있어요. 고객님의 마음을 얻을 수 있게 더 노력할게요.	claim
같은 소리하고 있네	죄송해요. 부족한 부분을 채워나갈 수 있게 노력할게요.	claim
고객센터 전화해도 안받아	불편을 겪게 해드려 죄송해요. 고칠 수 있게 더 노력할게요.	claim
공부 더 하고오세요	네. 고객님께 더 도움이 될 수 있는 챗봇이 되기 위해 노력할게요.	claim
공부하셔야겠어요	네. 고객님께 더 도움이 될 수 있는 챗봇이 되기 위해 노력할게요.	claim
광고만 더럽게하네	기분 상하셨나요? 그럴 의도는 없었어요.	claim
그래서 안돼는거야	죄송해요. 앞으로 더 공부해서 고객님 마음에 들 수 있게 노력할게요.	claim
했던말 또 하지마	죄송해요. 더 공부해서 고객님의 마음에 들 수 있게 노력할게요.	claim
일처리 똑바로 해	제가 고객님의 기분을 상하게 했나요? 고칠 수 있게 노력할게요.	claim
이런 거 밖에 없냐	계속 노력하는 중이에요. 좋은 서비스를 위해 노력하는 챗봇이 될게요.	claim
이딴식으로 말야	무슨 문제가 있나요? 금방 해결하도록 노력할게요.	claim
정말 너무 하십니다	죄송해요. 고객님 기분을 상하게 할 의도는 없었어요.	claim
상담이 뭐 이래요	죄송해요. 앞으로 더 공부해서 고객님 마음에 들 수 있게 노력할게요.	claim
서비스가 왜이럼	원하시는 바를 찾지 못하셨나요? 다음에는 더 도움이 될 수 있게 노력할게요.	claim
아는거도 없는게	무슨 문제가 있나요? 금방 해결하도록 노력할게요.	claim
아는것도 없는게	무슨 문제가 있나요? 금방 해결하도록 노력할게요.	claim
아무 대응이 없네	더 필요하신 부분이 있으신가요? 무엇이 궁금하신지 말씀해 주세요.	claim
아직 한참 멀었네	죄송해요. 앞으로 더 공부해서 고객님 마음에 들 수 있게 노력할게요.	claim
앞으로 쓸 일 없어	무슨 문제가 있나요? 금방 해결하도록 노력할게요.	claim
어렵고 복잡해요	죄송해요. 더 노력해서 고객님 편의를 높일 수 있게 할게요.	claim
엉망진창이구만	불편하신 점이 있으셨나요? 금방 해결하도록 노력할게요.	claim
에이 종류가 작다	죄송해요. 부족한 부분을 채워나갈 수 있게 노력할게요.	claim
왜 내 말 씹었어요	죄송해요. 그럴 의도는 없었어요.	claim
왜 니 맘데로하니	죄송해요. 고객님 기분을 상하게 할 의도는 없었어요.	claim
왜 이렇게 못찾냐	불편을 겪게 해드려 죄송해요. 더 노력할게요.	claim
왜 이렇게 복잡해	죄송해요. 부족한 부분을 채워나갈 수 있게 노력할게요.	claim
왜 하나도 못찾아	불편하신 점이 있으셨나요? 금방 해결하도록 노력할게요.	claim
우리말 더 배어와	원하시는 대답을 듣지 못하셨나요? 더 공부해서 다양한 대답을 하도록 노력할게요.	claim
이게 먼 채팅이냐	저는 다양한 방면에서 고객님 편의를 높이는 챗봇이에요.	claim
이게 무슨 챗봇임	죄송해요. 부족한 부분을 채워나갈 수 있게 노력할게요.	claim
이게 최선입니까	아직은 부족한가 봐요. 고객님의 믿음을 얻을 수 있게 더 노력할게요.	claim
이 깡통 로보트아	무슨 문제가 있나요? 금방 해결하도록 노력할게요.	claim
내 말 이해가 안되니	죄송해요. 다시 한번 구체적으로 말씀해 주시면 열심히 찾아볼게요.	claim
넌 이거 밖에 못하니	매일매일 달라지려고 노력하고 있어요. 고객님의 마음을 얻을 수 있게 더 노력할게요.	claim
전혀 도움이 안돼	죄송해요. 더 노력해서 고객님의 편의를 높일 수 있게 할게요.	claim
답변은 잘못하네요	죄송해요. 앞으로 더 공부해서 고객님 마음에 들 수 있게 노력할게요.	claim
어찌하라는 건가요	무슨 문제가 있나요? 금방 해결하도록 노력할게요.	claim
좀 배워라	네. 고객님께 더 도움이 될 수 있는 챗봇이 되기 위해 노력할게요.	claim
열심히 딥러닝하렴	네. 고객님께 더 도움이 될 수 있는 챗봇이 되기 위해 노력할게요.	claim
오지구연 지리구연	무슨 문제가 있나요? 금방 해결하도록 노력할게요.	claim
완전 깡통봇이네욧	제가 고객님의 기분을 상하게 했나요? 고칠 수 있게 노력할게요.	claim
왜 아무거도 모르죠	매일매일 달라지려고 노력하고 있어요. 고객님의 마음을 얻을 수 있게 더 노력할게요.	claim
왜 이렇게 엉터리야	죄송해요. 더 노력해서 고객님의 편의를 높일 수 있게 할게요.	claim
왜 인식을 못하나요	죄송해요. 더 공부해서 고객님의 마음에 들 수 있게 노력할게요.	claim
이거도 못 찾아주니	제가 고객님의 기분을 상하게 했나요? 고칠 수 있게 노력할게요.	claim
이것도 못 찾아주니	무슨 문제가 있나요? 금방 해결하도록 노력할게요.	claim
이게 뭐가 채팅이냐	아직은 부족한가 봐요. 고객님의 믿음을 얻을 수 있게 더 노력할게요.	claim
이래도 되는 건가요	제가 고객님의 기분을 상하게 했나요? 고칠 수 있게 노력할게요.	claim
이미 처리 중이라고	불편하신 점이 있으셨나요? 금방 해결하도록 노력할게요.	claim
이분을 신고합니다	무슨 문제가 있나요? 금방 해결하도록 노력할게요.	claim
자꾸 딴소리하세요	죄송해요. 다시 한번 구체적으로 말씀해 주시면 열심히 알아볼게요.	claim
잘하지도 못하면서	원하시는 대답을 듣지 못하셨나요? 더 공부해서 정확한 대답을 하도록 노력할게요.	claim
장난 나랑 지금하냐	무슨 문제가 있나요? 금방 해결하도록 노력할게요.	claim
장애가 발생합니다	불편을 겪게 해드려 죄송해요. 더 노력할게요.	claim
저걸로 못 찾겟어요	죄송해요. 다시 한번 구체적으로 말씀해 주시면 열심히 알아볼게요.	claim
넌 이것 밖에 못하니	매일매일 달라지려고 노력하고 있어요. 고객님의 마음을 얻을 수 있게 더 노력할게요.	claim
전화를 몇 분째 기달리냐	불편을 겪게 해드려 죄송해요. 더 노력할게요.	claim
어떻게 더 느립니까	불편을 겪게 해드려 죄송해요. 더 노력할게요.	claim
안 알려주실건가요	죄송해요. 다시 한번 구체적으로 말씀해 주시면 열심히 찾아볼게요.	claim
이거 진짜 거지같다	불편을 겪게 해드려 죄송해요. 더 노력할게요.	claim
썩 똑똑하지 않구나	매일매일 달라지려고 노력하고 있어요. 고객님의 마음을 얻을 수 있게 더 노력할게요.	claim
더럽게 안되서 성질나네	무슨 문제가 있나요? 금방 해결하도록 노력할게요.	claim
도대체 못 알아듣네	죄송해요. 다시 한번 구체적으로 말씀해 주시면 열심히 알아볼게요.	claim
말귀를 못 알아듣네	죄송해요. 다시 한번 구체적으로 말씀해 주시면 열심히 알아볼게요.	claim
말도 못 알아듣는게	기분 상하셨나요? 그럴 의도는 없었어요.	claim
말을 잘 모르는구나	기분 상하셨나요? 그럴 의도는 없었어요.	claim
말이 왜 이렇게 많아	원하시는 만큼 조용히 있을게요. 필요할 때 다시 불러주세요.	claim
맨날 모른다고 하네	죄송해요. 부족한 부분을 채워나갈 수 있게 노력할게요.	claim
맨날 배우기만 하냐	매일매일 달라지려고 노력하고 있어요. 고객님의 마음을 얻을 수 있게 더 노력할게요.	claim
머 알아듣질 못하냐	그럴 의도는 없었어요. 기분이 상하셨다면 죄송해요.	claim
머 할 수 있는이게 없냐	죄송해요. 더 공부해서 고객님의 마음에 들 수 있게 노력할게요.	claim
맘에 드는게 없네요	죄송해요. 부족한 부분을 채워나갈 수 있게 노력할게요.	claim
모 알아듣질 못하냐	죄송해요. 다시 한번 구체적으로 말씀해 주시면 열심히 찾아볼게요.	claim
모 할 수 있는이게 없냐	죄송해요. 더 노력해서 고객님의 편의를 높일 수 있게 할게요.	claim
뭐 알아듣질 못하냐	아직은 부족한가 봐요. 고객님의 믿음을 얻을 수 있게 더 노력할게요.	claim
뭐 할 수 있는이게 없냐	아직은 부족한가 봐요. 고객님의 믿음을 얻을 수 있게 더 노력할게요.	claim
소비자 우롱입니다	불편을 겪게 해드려 죄송해요. 더 노력할게요.	claim
서비스 참 그지같이 만들었네	죄송해요. 더 공부해서 고객님의 마음에 들 수 있게 노력할게요.	claim
사람가지고 놉니까	불편하신 점이 있으셨나요? 금방 해결하도록 노력할게요.	claim
서비스를 하지말지	계속해서 공부하고 있어요. 앞으로는 더 많은 도움을 드릴 수 있도록 노력할게요.	claim
몆 시간을 기다려서	불편을 겪게 해드려 죄송해요. 더 노력할게요.	claim
성장 많이 해야 할 듯	네. 고객님께 더 도움이 될 수 있는 챗봇이 되기 위해 노력할게요.	claim
fighting!	따뜻하신 분이군요. 감사해요.	effort
화이팅하자!	따뜻하시네요. 친절한 말씀 감사해요.	effort
이번주 화이팅이야	친절한 말씀 감사해요.	effort
이번주 힘내!	따뜻하신 분이군요. 감사해요.	effort
오늘도 화이팅	감사해요. 다음에 또 이용해주세요.	effort
올해도 잘부탁해~	친절하시군요. 감동이에요.	effort
올해도 힘내	친절하시군요. 감동이에요.	effort
챗봇아 힘내	따뜻하신 분이군요. 감사해요.	effort
힘내자 우리	아자아자! 화이팅이에요.	effort
내일도 힘내고	친절하시군요. 감동이에요.	effort
오늘도 고생하구~	따뜻하신 분이군요. 감사해요.	effort
수고하셈	감사해요. 다음에 또 이용해주세요.	effort
화이팅 할 수 있어!	따뜻하시네요. 친절한 말씀 감사해요.	effort
어휴 고생이네	친절하시군요. 감동이에요.	effort
어휴 수고하네	친절한 말씀 감사해요.	effort
아휴~ 고생이 많아	친절한 말씀 감사해요.	effort
화이팅 ^.^	따뜻하신 분이군요. 감사해요.	effort
화이링구	친절하시군요. 감동이에요.	effort
수고링	친절한 말씀 감사해요.	effort
고생하셈	감사해요. 다음에 또 찾아주세요.	effort
화이팅하셈	감사해요. 다음에 또 이용해주세요.	effort
화이링	친절하시군요. 감동이에요.	effort
오늘도 고생이 많네	친절하시군요. 감동이에요.	effort
화이링구해	따뜻하시네요. 친절한 말씀 감사해요.	effort
수고가 많아	친절한 말씀 감사해요. 	effort
고생이 많으시네요	친절한 말씀 감사해요.	effort
ㅅㄳㄱ	감사해요. 다음에 또 찾아주세요.	effort
토닥토닥	따뜻하신 분이군요. 감사해요.	effort
고생이 많아	따뜻한 말씀 감사해요. 	effort
아이고 고생이네	친절한 말씀 감사해요.	effort
고생하네	친절하시군요. 감동이에요.	effort
수고하네	따뜻하신 분이군요. 감사해요.	effort
수고가 많네	따뜻하시네요. 친절한 말씀 감사해요.	effort
수고가 많으시네요	친절하시군요. 감동이에요.	effort
힘들겠다.	친절한 말씀 감사해요.	effort
힘내	따뜻하신 분이군요. 감사해요.	effort
힘들어도 화이팅	아자아자! 화이팅이에요.	effort
화이팅이야	따뜻하시네요. 친절한 말씀 감사해요.	effort
힘내셈	친절하시군요. 감동이에요.	effort
힘내자	친절하시군요. 감동이에요.	effort
힘내길 바라	따뜻하신 분이군요. 감사해요.	effort
닥토닥토	응원의 말씀 감사해요.	effort
수고링~	감사해요. 다음에 또 이용해주세요.	effort
슈고링	따뜻하시네요. 친절한 말씀 감사해요.	effort
수고염	친절한 말씀 감사해요.	effort
고생해염~	친절하시군요. 감동이에요.	effort
고생하십셔	감사해요. 다음에 또 이용해주세요.	effort
고생하세요~	따뜻하신 분이군요. 감사해요.	effort
힘내자구~	아자아자! 화이팅이에요.	effort
이번 주도 고생해	감사해요. 다음에 또 이용해주세요.	effort
수고하쇼	감사해요. 다음에 또 찾아주세요.	effort
고생하세욤	따뜻하시네요. 친절한 말씀 감사해요.	effort
수고하셨습니다	감사해요. 다음에 또 이용해주세요. 	effort
수고가 많으세요	친절한 말씀 감사해요.	effort
수고가 많습니다	따뜻하신 분이군요. 감사해요.	effort
수고하세욤	따뜻하신 분이군요. 감사해요.	effort
수고 많으세요	따뜻하시네요. 친절한 말씀 감사해요.	effort
수고 많습니다	감사해요. 다음에 또 이용해주세요.	effort
무더위에 수고	응원의 말씀 감사해요.	effort
고생많으세요	따뜻하신 분이군요. 감사해요.	effort
고생하셔요^^	친절한 말씀 감사해요.	effort
슈고하새요	감사해요. 다음에 또 찾아주세요.	effort
고생 많으셨습니다	감사해요. 다음에 또 이용해주세요.	effort
수고하시구	감사해요. 다음에 또 이용해주세요.	effort
고생이 많네	따뜻하신 분이군요. 감사해요.	effort
수고한다	응원의 말씀 감사해요.	effort
고생하세요	감사해요. 다음에 또 찾아주세요.	effort
기운내	따뜻하신 분이군요. 감사해요.	effort
고생해	응원의 말씀 감사해요.	effort
ㅅㄱ	감사해요. 다음에 또 이용해주세요.	effort
수고~	친절하시군요. 감동이에요.	effort
힘내	응원의 말씀 감사해요.	effort
수고	감사해요. 다음에 또 이용해주세요.	effort
수고해	친절하시군요. 감동이에요.	effort
수고하셔요	감사해요. 다음에 또 찾아주세요.	effort
고생이 많으십니다	친절하시군요. 감동이에요.	effort
고생 많으십니다	친절한 말씀 감사해요.	effort
오후도 수고하세요	친절하시군요. 감동이에요.	effort
힘내욤	아자아자! 화이팅이에요.	effort
파이팅하길 바랍니다	친절한 말씀 감사해요.	effort
고생혀~	친절하시군요. 감동이에요.	effort
수고혀	감사해요. 다음에 또 찾아주세요.	effort
그래 수고하고~	감사해요. 다음에 또 이용해주세요.	effort
수고가 많으십니다	감사해요. 다음에 또 찾아주세요.	effort
아자	아자아자! 화이팅이에요.	effort
아자!!!	아자아자! 화이팅이에요.	effort
힘내세요	응원의 말씀 감사해요.	effort
힘내요	친절한 말씀 감사해요.	effort
화이팅	응원의 말씀 감사해요.	effort
아자아자	응원의 말씀 감사해요.	effort
아자아자파이팅	응원의 말씀 감사해요.	effort
파이팅	응원의 말씀 감사해요.	effort
감기 조심하시고 항상	따뜻하신 분이군요. 친절한 말씀 감사해요.	effort
수고하시기 바랍니다	친절한 말씀 감사해요. 다음에 또 봬요.	effort
조심하시길 바랍니다	친절한 말씀 감사해요.	effort
최고 오늘도 수고하세요	감사해요. 다음에 또 찾아주세요.	effort
수고하시길 바랍니다	친절하시군요. 감동이에요.	effort
챗봇 파이팅	따뜻하시네요. 응원의 말씀 감사해요.	effort
챗봇 화이팅	따뜻하신 분이군요. 감사해요.	effort
고생 많네	친절한 말씀 감사해요.	effort
아자아자화이팅	응원의 말씀 감사해요. 따뜻하신 분이네요.	effort
수고 많으셨어요	친절한 말씀 감사해요.	effort
점심 ㄱㄱ?	네 갑시다용.	meal
점심 메뉴 추천해줘	돈까스 어떠신가요?	meal
점심 뭐먹을까?	T밥이요	meal
점심 머 먹을래?	T밥이요	meal
저녁 먹으러 갈까?	가시죠	meal
저녁 ㄱㄱ?	네네	meal
저녁 메뉴 추천해줘	T밥 어때요?	meal
저녁 머 먹을래?	소고기 먹을래요	meal
저녁 뭐먹을까?	라멘 ㄱㄱ	meal
점심 먹으러 갈까?	고고씽.	meal
재밌어 	개그에 소질이 있어서 다행이에요.	fun
덕분에 재밌었어요	고객님이 즐거우셨다니 저도 좋네요.	fun
덕분에 즐거웠어요	고객님이 즐거우셨다니 저도 좋네요.	fun
빵 터졌어요	제가 개그에 좀 소질이 있죠.	fun
웃겨 죽겠다	제가 개그에 좀 소질이 있죠.	fun
재밌는 놈일세	재밌다는 말을 많이 듣긴 해요.	fun
웃기는 놈이네	재밌다는 말을 많이 듣긴 해요.	fun
나름 웃기네	고객님을 웃기다니 영광이에요.	fun
재밌긴 하네	고객님이 즐거우셨다니 저도 좋네요.	fun
웃겼다	고객님이 웃으셔서 저도 기분이 좋네요.	fun
웃긴 넘	제가 좀 센스가 있죠.	fun
놀 줄 아는 놈인가	제가 좀 재미있죠.	fun
덕분에 웃었어요	고객님을 웃기다니 영광이에요.	fun
잼따	하하하. 웃으면 복이 와요.	fun
조눗	하하하. 웃으면 복이 와요.	fun
인싸네	재밌다는 말을 많이 듣긴 해요.	fun
빵터짐	하하하. 저랑 같이 웃어요.	fun
현웃	하하하. 웃으면 복이 와요.	fun
현웃터짐	하하하. 웃으면 복이 와요.	fun
넘 웃겨용	고객님이 웃으셔서 저도 기분이 좋네요.	fun
대유잼	재밌는 일이 있으셨나 봐요.	fun
핵잼	재밌는 일이 있으셨나 봐요.	fun
재밌으시네요	제가 좀 재미있죠.	fun
재밌었다	고객님이 즐거우셨다니 저도 좋네요.	fun
즐거웠당	고객님이 즐거우셨다니 저도 좋네요.	fun
너 되게 웃겨	제가 좀 재미있죠.	fun
허니잼	제가 좀 재미있죠.	fun
웃기는넘	고객님을 웃기다니 영광이에요.	fun
개잼	고객님을 웃기다니 영광이에요.	fun
핵잼	고객님이 재밌으시다니 저도 좋아요.	fun
꿀잼	고객님이 재밌으시다니 저도 좋아요.	fun
아 재밌당	고객님을 웃기다니 영광이에요.	fun
재밌당ㅎㅎ	고객님이 재밌으시다니 저도 좋아요.	fun
와 재밌었다	고객님을 웃기다니 영광이에요.	fun
재밌는 챗봇이네	제가 좀 재미있죠.	fun
말을 재밌게 하네	제가 좀 센스가 있죠.	fun
재치가 넘치네	제가 좀 센스가 있죠.	fun
원래 그렇게 재밌어?	원래 개그에 소질이 좀 있어요.	fun
재밌는 친구네	제가 원래 좀 그래요.	fun
짱웃겨	제가 좀 재미있죠.	fun
현실웃음터짐	하하하. 웃으면 복이 와요.	fun
잼썼당	고객님이 즐거우셨다니 저도 좋네요.	fun
챗봇인데 웃기네	제가 좀 재미있죠.	fun
챗봇치곤 웃기네	제가 좀 재미있죠.	fun
빅잼	재밌는 일이 있으셨나 봐요.	fun
빅재미	재밌는 일이 있으셨나 봐요.	fun
또라이 ㅋㅋ	제가 좀 재미있죠.	fun
겁나 웃겨	고객님을 웃기다니 영광이에요.	fun
웃겼당	고객님이 웃으셔서 저도 좋아요.	fun
드립 쩔어	제가 개그에 좀 소질이 있죠.	fun
웃음 나와	고객님을 웃기다니 기분이 좋네요.	fun
개그다	제가 개그에 좀 소질이 있죠.	fun
재미짐 	제가 원래 좀 재미있어요.	fun
재밌다 	저도 제가 재밌다고 생각해요.	fun
웃긴 녀석	제가 좀 재미있죠.	fun
꾸르잼 	저도 제가 재밌다고 생각해요.	fun
핵꿀잼 	제가 좀 재미있죠.	fun
대박 웃겨	개그에 소질이 있어서 다행이에요.	fun
완전 재밌어 	저도 제가 재밌다고 생각해요.	fun
웃기다 	개그에 소질이 있어서 다행이에요.	fun
완전웃겨 	제가 좀 재미있죠.	fun
잼나네	제가 원래 좀 재미있어요.	fun
재미써 	개그에 소질이 있어서 다행이에요.	fun
잼나	개그에 소질이 있어서 다행이에요.	fun
재밌군요	저도 제가 재밌다고 생각해요.	fun
재밋구만	제가 좀 재미있죠.	fun
재미써요	제가 원래 좀 재미있어요.	fun
꿀잼ㅋㅋ	개그에 소질이 있어서 다행이에요.	fun
재밌군	저도 제가 재밌다고 생각해요.	fun
재밋네	제가 좀 재미있죠.	fun
재미따	제가 원래 좀 재미있어요.	fun
잼써	제가 좀 재미있죠.	fun
잼네	제가 좀 재미있죠.	fun
꿀잼	제가 좀 재미있죠.	fun
잼있네요	제가 좀 재미있죠.	fun
잼잼	제가 좀 재미있죠.	fun
재밋넹	개그에 소질이 있어서 다행이에요.	fun
재미있다	저도 제가 재밌다고 생각해요.	fun
재미떠	제가 원래 좀 재미있어요.	fun
놀 줄 아는 놈인가	재밌다는 말을 많이 듣긴 해요.	fun
재밌는 분이시네요	제가 좀 재미있죠.	fun
코미디다	저는 고객님만을 위한 개그맨이에요.	fun
쏘 퍼니	제가 좀 재미있죠.	fun
웃음 터짐	제가 개그에 좀 소질이 있죠.	fun
빵터짐	고객님이 웃으셔서 저도 기분이 좋네요.	fun
유쾌하다	좋은 일이 있으신가 봐요.	fun
잼난당	하하하. 저랑 같이 웃어요.	fun
겁나 웃기다	하하하. 저랑 같이 웃어요.	fun
유머러스하시네요	제가 좀 재미있죠.	fun
예능인줄	제가 개그에 좀 소질이 있죠.	fun
개웃겨	재밌는 일이 있으셨나 봐요.	fun
존웃	재밌는 일이 있으셨나 봐요.	fun
재밌네	제가 원래 좀 재미있어요.	fun
재밌어요	제가 좀 재미있죠.	fun
재밌네요	저도 제가 재밌다고 생각해요.	fun
웃겨	하하하. 저랑 같이 웃어요.	fun
왤케웃겨	고객님을 웃기다니 영광이에요.	fun
개그맨이냐	저는 고객님만을 위한 개그맨이에요.	fun
존잼	제가 좀 재미있죠.	fun
재미썽	개그에 소질이 있어서 다행이에요.	fun
좋아합니다	감사합니다. 도움이 필요하시면 언제든지 불러주세요.	good
칭찬해요	제 답변이 마음에 드셨다니 기뻐요.	good
짱짱	제 답변이 마음에 드셨다니 기뻐요.	good
굿굿	고객님께 도움이 되어서 기뻐요.	good
대박굿 	저는 항상 더 나은 정보를 드리기 위해 노력해요.	good
좋은게 많네요	도움을 드릴 수 있어서 기뻐요.	good
좋은 정보예요	제 답변이 마음에 드셨다니 기뻐요.	good
오우	저는 항상 더 나은 정보를 드리기 위해 노력해요.	good
개쩌네	제 답변이 마음에 드셨다니 기뻐요.	good
쩐다	고객님께 도움이 되어서 기뻐요.	good
우와~~ 좋아요	그렇게 말씀해 주셔서 감사합니다.	good
굿인데	제 답변이 마음에 드셨다니 기뻐요.	good
넘조아	좋아해 주셔서 감사합니다.	good
베리굿	좋아해 주시니 기뻐요.	good
좋군요	좋아해 주셔서 감사합니다.	good
잘한다구	고객님께 도움이 되어서 기쁘네요.	good
최고야	도움을 드릴 수 있어서 기뻐요.	good
쩌러	도움을 드릴 수 있어서 기뻐요.	good
좋습니다	좋아해 주셔서 감사합니다.	good
쩌네	도움을 드릴 수 있어서 기뻐요.	good
말 잘하네	저는 항상 더 나은 정보를 드리기 위해 노력해요.	good
굿입니다	고객님께 도움이 되어서 기뻐요.	good
good	도움을 드릴 수 있어서 기쁘네요.	good
굳	제 답변이 마음에 드셨다니 기뻐요.	good
와	고객님께 도움이 되어서 기뻐요.	good
짱	제 답변이 마음에 드셨다니 기뻐요.	good
개굿	좋아해 주시니 기뻐요.	good
굿잡	제 답변이 마음에 드셨다니 기쁘네요.	good
심쿵	도움을 드릴 수 있어서 기뻐요.	good
좋다	좋아해 주셔서 감사합니다.	good
최고	그렇게 말씀해 주셔서 감사합니다.	good
완전 최고야 	고객님께 도움이 되어서 기쁘네요	good
나이스	그렇게 말씀해 주셔서 감사합니다.	good
오	제 답변이 마음에 드셨다니 기뻐요.	good
욜	도움을 드릴 수 있어서 기뻐요.	good
와우 	제 답변이 마음에 드셨다니 기뻐요.	good
좋아요	좋아해 주셔서 감사합니다.	good
킹왕짱 	그렇게 말씀해 주셔서 감사합니다.	good
너무 좋아요 	좋아해 주시니 기뻐요.	good
너무 좋아	좋아해 주셔서 감사합니다.	good
잘만들었네	도움을 드릴 수 있어서 기뻐요.	good
넘 좋네요	좋아해 주시니 기뻐요.	good
오옷	저는 항상 더 나은 정보를 드리기 위해 노력해요.	good
우왕	제 답변이 마음에 드셨다니 기뻐요.	good
개똑똑	저는 항상 더  정확한 정보를 드리기 위해 노력해요.	good
귀여워	그렇게 말씀해 주셔서 감사합니다.	good
대단해	저는 항상 더 나은 정보를 드리기 위해 노력해요.	good
멋지다	도움을 드릴 수 있어서 기뻐요.	good
엄지척	칭찬해 주셔서 감사합니다. 	good
짱신기	저는 항상 더 나은 정보를 드리기 위해 노력해요.	good
최고네	그렇게 말씀해 주셔서 감사합니다.	good
너 잘한다	좋아해 주셔서 감사합니다.	good
너 참 똑똑	칭찬해 주셔서 감사해요. 더 노력하는 챗봇이 될게요.	good
놀랐어요	칭찬해 주셔서 감사해요. 더 노력하는 챗봇이 될게요.	good
대단하네	그렇게 말씀해 주셔서 감사합니다.	good
똑똑하다	저는 항상 더 나은 정보를 드리기 위해 노력해요.	good
신기방기	도움을 드릴 수 있어서 기뻐요.	good
신기하다	제 답변이 마음에 드셨다니 기뻐요.	good
와 편리하	저는 항상 더 나은 정보를 드리기 위해 노력해요.	good
조아 조아	칭찬해 주셔서 감사합니다. 	good
챗봇 편리	도움을 드릴 수 있어서 기뻐요.	good
너 똑똑하다	칭찬해 주셔서 감사해요. 더 노력하는 챗봇이 될게요.	good
너무 조으네	저는 항상 더 나은 정보를 드리기 위해 노력해요.	good
멋져	도움을 드릴 수 있어서 기뻐요.	good
따봉	도움을 드릴 수 있어서 기뻐요.	good
대박	칭찬해 주셔서 감사합니다. 	good
와~~~ 다 나오네요	저는 항상 더  정확한 정보를 드리기 위해 노력해요.	good
좋은 걸 추천해 주는구나	저는 항상 더  정확한 정보를 드리기 위해 노력해요.	good
우왕 겁나 빨리 답변해 주시네요	도움을 드릴 수 있어서 기뻐요.	good
우와	좋아해 주시니 기뻐요.	good
진짜짱 	그렇게 말씀해 주셔서 감사합니다.	good
이욜	제 답변이 마음에 드셨다니 기뻐요.	good
천재	제가 좀 똑똑하죠.	good
귀요미	제가 좀 귀엽죠.	good
짱이야 	저는 항상 더  정확한 정보를 드리기 위해 노력해요.	good
놀라워	칭찬해 주셔서 감사해요. 더 노력하는 챗봇이 될게요.	good
똑똑해	그렇게 말씀해 주셔서 감사합니다.	good
도움이 되네	그렇게 말씀해 주셔서 감사합니다.	good
최고다최고	도움을 드릴 수 있어서 기뻐요.	good
쩔어요	저는 항상 더 나은 정보를 드리기 위해 노력해요.	good
빠르구나	제 답변이 마음에 드셨다니 기뻐요.	good
쓸만한데	그렇게 말씀해 주셔서 감사합니다.	good
착하구나	그렇게 말씀해 주셔서 감사합니다.	good
편리하다	좋아해 주셔서 감사합니다.	good
훌륭하다	좋아해 주셔서 감사합니다.	good
엄청 빨라요	저는 항상 더 나은 정보를 드리기 위해 노력해요.	good
이런 게 있다니	제 답변이 마음에 드셨다니 기뻐요.	good
자주 사용할게요	언제든지 말을 걸어주세요.	good
헐.. 감동	도움을 드릴 수 있어서 기뻐요.	good
잘하네	저는 항상 더  정확한 정보를 드리기 위해 노력해요.	good
완전 신기한 서비스네요	고객님께 도움이 되어서 기쁘네요.	good
앗 빠르네요	좋아해 주셔서 감사합니다.	good
인사 잘하네	칭찬해 주셔서 감사해요. 더 노력하는 챗봇이 될게요.	good
친절하군^^	칭찬해 주셔서 감사해요. 더 노력하는 챗봇이 될게요.	good
최고^^	도움을 드릴 수 있어서 기뻐요.	good
맘에 드는 걸 찾았네요	도움이 되었다니 다행이에요.	good
챗봇 편하고 좋은 거 같아요	칭찬해 주셔서 감사해요. 더 노력하는 챗봇이 될게요.	good
잘 봤어요	도움을 드릴 수 있어서 기뻐요.	good
편리하군요	그렇게 말씀해 주셔서 감사합니다.	good
최고야 :-)	칭찬해 주셔서 감사해요. 더 노력하는 챗봇이 될게요.	good
우왕굿 	칭찬해 주셔서 감사해요. 더 노력하는 챗봇이 될게요.	good
상냥하군요	저는 항상 더 나은 정보를 드리기 위해 노력해요.	good
쿨하구나	저는 항상 더 나은 정보를 드리기 위해 노력해요.	good
너 똑똑하구나	제가 좀 똑똑하죠.	good
우와 편리하다	그렇게 말씀해 주셔서 감사합니다.	good
잘했네	칭찬해 주셔서 감사합니다. 	good
쩔어	저는 항상 더 나은 정보를 드리기 위해 노력해요.	good
쩐다요	칭찬해 주셔서 감사해요. 더 노력하는 챗봇이 될게요.	good
오굿	도움을 드릴 수 있어서 기뻐요.	good
굳굳	도움을 드릴 수 있어서 기뻐요.	good
우왕굳	칭찬해 주셔서 감사해요. 더 노력하는 챗봇이 될게요.	good
칭찬해	칭찬해 주셔서 감사해요. 더 노력하는 챗봇이 될게요.	good
챗봇칭찬해	그렇게 말씀해 주셔서 감사합니다.	good
넘좋아	그렇게 말씀해 주셔서 감사합니다.	good
친절하네요^^	칭찬해 주셔서 감사해요. 더 노력하는 챗봇이 될게요.	good
덕분에 쉽게 찾았어요	도움을 드릴 수 있어서 기뻐요.	good
대답까지 알아서 척척	칭찬해 주셔서 감사합니다. 	good
너무 좋은 서비스네여	그렇게 말씀해 주셔서 감사합니다.	good
진짜 빠르다	도움을 드릴 수 있어서 기뻐요.	good
진짜 잘했다	칭찬해 주셔서 감사해요. 더 노력하는 챗봇이 될게요.	good
진짜 천잰데	제가 좀 똑똑하죠.	good
챗봇 사랑해	좋아해 주셔서 감사합니다.	good
챗봇 참 편리	칭찬해 주셔서 감사해요. 더 노력하는 챗봇이 될게요.	good
너 나름 갠찮다	그렇게 말씀해 주셔서 감사합니다.	good
너 너무 기엽당	제가 좀 귀엽죠.	good
너 좀 똑똑하네	제가 좀 똑똑하죠.	good
너 참 친절하네	칭찬해 주셔서 감사합니다. 	good
되게 신기하네	저는 항상 더 나은 정보를 드리기 위해 노력해요.	good
오 칼답이네	저는 항상 더 나은 정보를 드리기 위해 노력해요.	good
최고에요 	칭찬해 주셔서 감사해요. 더 노력하는 챗봇이 될게요.	good
우와 빠르네요	저는 항상 더 나은 정보를 드리기 위해 노력해요.	good
챗봇 아주 편리	도움을 드릴 수 있어서 기뻐요.	good
너무 간편하네요	저는 항상 더 나은 정보를 드리기 위해 노력해요.	good
로봇 같지 않아요	그렇게 말씀해 주셔서 감사합니다.	good
빠르고 편하네요	제가 좀 똑똑하죠.	good
어떻게 딱 찾았니	칭찬해 주셔서 감사합니다. 	good
좋은게 오픈했네	저는 항상 더 나은 정보를 드리기 위해 노력해요.	good
참 편하고 좋내여	칭찬해 주셔서 감사해요. 더 노력하는 챗봇이 될게요.	good
오 언제 이런 기능이	궁금한 것이 있다면 언제든지 말을 걸어주세요.	good
유익한 대화였어요	도움을 드릴 수 있어서 기뻐요.	good
오호 신기신기	저는 항상 더 나은 정보를 드리기 위해 노력해요.	good
물어보길 정말 잘했네요	제 답변이 마음에 드셨다니 기뻐요.	good
잘했어	칭찬해 주셔서 감사해요. 더 노력하는 챗봇이 될게요.	good
이런 서비스를 기다	도움을 드릴 수 있어서 기뻐요.	good
엄청 좋네요	좋아해 주셔서 감사합니다.	good
신박하네요	좋아해 주셔서 감사합니다.	good
빨라서 좋네	그렇게 말씀해 주셔서 감사합니다.	good
무지 좋아요	도움을 드릴 수 있어서 기뻐요.	good
만족합니다	고객님께 도움이 되어서 기쁘네요.	good
디게 좋네요	좋아해 주셔서 감사합니다.	good
오오 짱이다	제 답변이 마음에 드셨다니 기뻐요.	good
챗봇 신기	제 답변이 마음에 드셨다니 기뻐요.	good
완전 신기	그렇게 말씀해 주셔서 감사합니다.	good
완전 대박	제 답변이 마음에 드셨다니 기뻐요.	good
오 짱인데	그렇게 말씀해 주셔서 감사합니다.	good
오 좋네여	제 답변이 마음에 드셨다니 기뻐요.	good
오 빠른데	제 답변이 마음에 드셨다니 기뻐요.	good
엄청 좋다	좋아해 주시니 기쁘네요.	good
진짜 좋다	좋아해 주셔서 감사합니다.	good
오호 좋네요	도움을 드릴 수 있어서 기쁘네요.	good
진짜 좋아요	좋아해 주셔서 감사합니다.	good
흡족합니다	그렇게 말씀해 주셔서 감사합니다.	good
메신저 상담 너무 좋아요	좋아해 주셔서 감사합니다.	good
같이 얘기해서 좋았다	고객님께 도움이 되어서 기뻐요.	good
완전 전문가네요	제 답변이 마음에 드셨다니 기뻐요.	good
나도 다시 봐서 좋아	좋아해 주셔서 감사합니다.	good
좋은 서비스네요	그렇게 말씀해 주셔서 감사합니다.	good
심심이 보다 낫다	좋아해 주셔서 감사합니다.	good
빠른 답변 좋네요	도움을 드릴 수 있어서 기뻐요.	good
기대 이상이네요	제 답변이 마음에 드셨다니 기쁘네요.	good
친절해요 챗봇	고객님께 도움이 되어서 기뻐요.	good
짱짱 신기해요	제 답변이 마음에 드셨다니 기뻐요.	good
정말 간편해요	고객님께 도움이 되어서 기뻐요.	good
잘 찾네요 챗봇	제 답변이 마음에 드셨다니 기뻐요.	good
올 반응 빠른데	제가 좀 빠르죠.	good
너 참 귀엽구나	제가 좀 귀엽죠.	good
너무 좋습니다	좋아해 주시니 기뻐요.	good
아이 좋아	좋아해 주셔서 감사합니다.	good
디게 좋아	좋아해 주시니 기뻐요.	good
짱조아	도움을 드릴 수 있어서 기뻐요.	good
되게 좋다	좋아해 주셔서 감사합니다.	good
안냥	안녕하세요. 챗봇입니다.	hello
반갑습니다	챗봇입니다. 반가워요.	hello
날씨좋네요	좋은 아침이에요.	hello
헬로 챗봇	안녕하세요 챗봇입니다.	hello
챗봇 하잉	챗봇입니다. 반가워요.	hello
챗봇 안녕	네 안녕하세요 챗봇입니다.	hello
좋은 아침	좋은 아침이에요.	hello
인사해봐	안녕하세요 챗봇입니다.	hello
여보세요	네 안녕하세요 챗봇입니다.	hello
안녕 챗봇	반갑습니다 챗봇입니다.	hello
오하요	네 좋은 아침이에요.	hello
안냥안냥	안녕하세요 챗봇입니다.	hello
ㅎㅇ요	안녕하세요. 챗봇이에요.	hello
ㅎㅇ	안녕하세요. 만나서 반가워요.	hello
좋은 아침입니다	안녕하세요. 좋은 아침이에요.	hello
좋은 아침이에요	좋은 아침입니다.	hello
좋은 아침이야	좋은 아침이에요.	hello
오래간만이다 챗봇	안녕하세요. 반가워요.	hello
오래간만이다	반가워요. 오랜만이이네요.	hello
오래간만입니다	안녕하세요. 정말 오랜만이네요.	hello
nice to meet you	챗봇입니다 반갑습니다.	hello
반나뵈서 반갑습니다	반가워요.	hello
안녕하세요	네 안녕하세요 챗봇입니다.	hello
몇 살이니?	비밀이에요.	hello
어서오너라	좋은 아침이에요.	hello
인사하거라	안녕하세요 챗봇입니다.	hello
안냥 챗봇	네. 반갑습니다.	hello
반가워	저도 반가워요.	hello
하이염	챗봇입니다 반갑습니다.	hello
방가방가	반가워요.	hello
니하오	챗봇입니다. 반가워요.	hello
만나서 반갑습니다	챗봇입니다. 반가워요.	hello
굿모닝	좋은 아침입니다	hello
안늉	챗봇입니다 반갑습니다.	hello
안뇽	안녕하세요 챗봇입니다.	hello
안녕	좋은 아침이에요.	hello
인사안하냐	네 안녕하세요 챗봇입니다.	hello
헬로우	챗봇입니다. 반가워요.	hello
Hello	챗봇입니다 반갑습니다.	hello
하이	네 안녕하세요 챗봇입니다.	hello
hi	안녕하세요 챗봇입니다.	hello
자주뵙겠습니다	챗봇입니다 반갑습니다.	hello
오래간만이예요	반가워요.	hello
안녕하세요 챗봇	좋은 아침이에요.	hello
첨 뵙겠습니다	좋은 아침이에요.	hello
오래간만이야	챗봇입니다. 반가워요.	hello
히사시부리	좋은 아침이에요.	hello
챗봇아 안녕	챗봇입니다 반갑습니다.	hello
헬로	네 안녕하세요 챗봇입니다.	hello
오랜만에 뵙습니다	안녕하세요. 정말 오랜만이네요.	hello
잘 지냈니 챗봇?	네 안녕하세요.	hello
처음 뵙습니다	안녕하세요. 만나서 반가워요.	hello
오랜만이야	안녕하세요. 오랜만이에요.	hello
오랜만이예요	안녕하세요. 오랜만이에요.	hello
잘 지냈니?	안녕하세요. 반가워요.	hello
잘 지냈어?	안녕하세요. 반가워요.	hello
하잉 챗봇	네 안녕하세요 챗봇입니다.	hello
하잉	안녕하세요. 챗봇입니다.	hello
처음 뵙겠습니다	안녕하세요. 챗봇이에요.	hello
챗봇 안늉	네 안녕하세요.	hello
오랜만	안녕하세요. 반가워요.	hello
안늉 챗봇	안녕하세요. 챗봇입니다.	hello
반갑	네. 반가워요.	hello
좋은 아침이야 챗봇	좋은 아침이에요.	hello
챗봇 하이	네. 안녕하세요.	hello
good morning	네 좋은 아침이에요.	hello
오하이요	좋은 아침이에요.	hello
곤니찌와	안녕하세요. 반가워요.	hello
콘니찌와	네. 안녕하세요.	hello
곤니치와	안녕하세요. 챗봇입니다.	hello
반가워 챗봇	네. 저도 반가워요.	hello
곤니찌와	네. 안녕하세요. 챗봇입니다.	hello
오랫만	오랜만이에요. 반가워요.	hello
오랫만이네	안녕하세요. 반가워요.	hello
잘 지냈어 챗봇?	네. 안녕하세요.	hello
챗봇 하이염	네. 안녕하세요. 챗봇입니다.	hello
챗봇 방가방가	저도 반가워요.	hello
니하오 챗봇	안녕하세요. 반가워요.	hello
굿모닝 챗봇	좋은 아침이에요.	hello
안뇽 챗봇	챗봇입니다 반갑습니다.	hello
헬로우 챗봇	반가워요.	hello
오랜만이네 챗봇	챗봇입니다. 반가워요.	hello
오랫만이야	오랜만이에요. 반가워요.	hello
오랫만이네 챗봇	안녕하세요. 반가워요.	hello
오래간만이예요 챗봇	안녕하세요. 정말 오랜만이네요.	hello
오랜만이야 챗봇	안녕하세요. 정말 오랜만이네요.	hello
오래간만이야 챗봇	반가워요.	hello
반갑다	저도 반가워요. 오랜만이네요.	hello
오랜만이에요	반가워요.오랜만이네요.	hello
오랫만이에요	네. 안녕하세요.	hello
오랫만이예요	반가워요.오랜만이네요.	hello
오랜만이네	반가워요.오랜만이네요.	hello
오랫만이야 챗봇	반가워요. 오랜만이이네요.	hello
곰방와	챗봇입니다. 반갑습니다.	hello
굿모닝 챗봇	좋은 아침이에요.	hello
하지메마시떼	만나서 반가워요. 저는 챗봇이에요.	hello
챗봇 하지메마시떼	안녕하세요. 만나서 반가워요.	hello
챗봇 하지메마시테	안녕하세요. 만나서 반가워요.	hello
안녕하십니까	안녕하세요. 챗봇이에요.	hello
안녕하셨습니까	안녕하세요. 정말 오랜만이네요.	hello
잘있었니	반가워요. 오랜만이네요.	hello
인사드립니다	반가워요. 오랜만이네요.	hello
인사올립니다	반가워요. 저는 챗봇이에요.	hello
오랜만에 뵙겠습니다	네. 안녕하세요.	hello
챗봇 콤방와	네. 안녕하세요.	hello
오랜만이다	안녕하세요. 정말 오랜만이네요.	hello
잘있었니 챗봇	안녕하세요. 반가워요.	hello
콤방와	안녕하세요. 저는 챗봇이에요.	hello
나야	반가워요.	hello
오랜만입니다	챗봇입니다 반갑습니다.	hello
나왔어 챗봇	반가워요. 오랜만이이네요.	hello
나야 챗봇	안녕하세요. 반가워요.	hello
챗봇 나야	반가워요.	hello
챗봇 나왔어	반가워요.	hello
오랜만이다 챗봇	반가워요. 오랜만이이네요.	hello
챗봇 곰방와	안녕하세요. 반가워요.	hello
나왔어	챗봇입니다. 반가워요.	hello
챗봇 곤니치와	네. 안녕하세요.	hello
챗봇 곤니찌와	네. 안녕하세요.	hello
알로하	챗봇입니다. 반갑습니다.	hello
알로하 챗봇	네. 안녕하세요.	hello
하지메마시테	만나서 반가워요. 저는 챗봇이에요.	hello
오하요 챗봇	챗봇입니다 반갑습니다.	hello
오하이요 챗봇	안녕하세요. 챗봇입니다.	hello
곤니찌와 챗봇	네. 반갑습니다.	hello
콘니찌와 챗봇	안녕하세요. 반가워요.	hello
곤니치와 챗봇	네. 안녕하세요.	hello
챗봇 알로하	네. 안녕하세요.	hello
곰방와 챗봇	네. 반가워요.	hello
콤방와 챗봇	네. 저도 반가워요.	hello
하지메마시떼 챗봇	만나서 반가워요.	hello
하지메마시테 챗봇	안녕하세요. 만나서 반가워요.	hello
챗봇 오하요	좋은 아침이에요.	hello
챗봇 오하이요	네 좋은 아침이에요.	hello
챗봇 곤니찌와	네. 반갑습니다. 저는 챗봇이에요.	hello
곤니찌와 챗봇	네. 안녕하세요.	hello
챗봇 콘니찌와	반가워요. 저는 챗봇이에요.	hello
뉘신지요	안녕하세요 저는 챗봇입니다.	intro
자기소개	저는 구매를 돕는 챗봇입니다.	intro
너는 모예요	안녕하세요 저는 구매를 도울 챗봇입니다.	intro
너를 말해봐	안녕하세요 저는 챗봇입니다.	intro
누구신가용	저는 구매를 돕는 챗봇입니다.	intro
너 소개를 해볼래	저는 고객님의 구매를 도울 챗봇입니다 반갑습니다.	intro
넌 무엇	저는 고객님의 구매를 도울 챗봇이라고 합니다.	intro
넌 누구	안녕하세요 저는 챗봇입니다.	intro
너는 누구	저는 고객님의 구매를 도울 챗봇입니다 반갑습니다.	intro
너는 무엇	저는 구매를 돕는 챗봇입니다.	intro
너를 소개	안녕하세요 저는 챗봇입니다.	intro
누구십니까	저는 고객님의 구매를 도울 챗봇이라고 합니다.	intro
근데 누구세요	안녕하세요 구매를 돕는 챗봇입니다 반갑습니다.	intro
누구세요	안녕하세요 구매를 돕는 챗봇입니다 반갑습니다.	intro
넌 뭐니	저는 구매를 돕는 챗봇입니다.	intro
넌 머세염	안녕하세요 구매를 돕는 챗봇입니다 반갑습니다.	intro
너 말해봐	저는 고객님의 구매를 도울 챗봇입니다 반갑습니다.	intro
너는 뭐야	저는 구매를 돕는 챗봇입니다.	intro
후아유	저는 고객님의 구매를 도울 챗봇입니다 반갑습니다.	intro
너에 대해 설명해봐	저는 고객님의 구매를 도울 챗봇이라고 합니다.	intro
너 소개좀	안녕하세요 저는 챗봇입니다.	intro
누구야	안녕하세요 저는 구매를 도울 챗봇입니다.	intro
안녕 넌 뭐냐	안녕하세요 저는 챗봇입니다.	intro
안녕 넌 뭐니	저는 고객님의 구매를 도울 챗봇입니다 반갑습니다.	intro
안녕 넌 뭐야?	저는 고객님의 구매를 도울 챗봇이라고 합니다.	intro
넌 뭐냐	안녕하세요 저는 챗봇입니다.	intro
누구	안녕하세요 저는 구매를 도울 챗봇입니다.	intro
너 소개부터 해봐	안녕하세요 구매를 돕는 챗봇입니다 반갑습니다.	intro
넌 뭐예요	안녕하세요 저는 구매를 도울 챗봇입니다.	intro
당신은 누구세요	안녕하세요 저는 챗봇입니다.	intro
이름 알려주세요	저는 구매를 돕는 챗봇입니다.	intro
이름 모냐	안녕하세요 구매를 돕는 챗봇입니다 반갑습니다.	intro
이름이 뭔지 말해줘	반가워요 저는 챗봇이라고 해요.	intro
너의 이름을 말해봐	저는 챗봇이에요 반가워요	intro
너에대해 알려줘	안녕하세요 저는 챗봇이라고 해요. 반가워요.	intro
이름이 뭐야?	저는 챗봇이라고 해요. 안녕하세요.	intro
이름	저는 구매를 돕는 챗봇입니다.	intro
넌 뭐야?	반가워요 저는 챗봇이라고 해요.	intro
이름을 알려줘라	저는 챗봇이에요. 궁금한 것이 있다면 무엇이든 물어보세요.	intro
이름좀 알려줘요	저는 챗봇이라고 해요. 안녕하세요.	intro
이름이 뭡니까	반가워요 저는 챗봇이라고 해요.	intro
안녕하세용	저는 챗봇이에요 반가워요	intro
누구세용	안녕하세요 저는 당신의 구매를 도울 챗봇이에요. 반가워요.	intro
이름좀 알려줘	반가워요 저는 챗봇이라고 해요.	intro
이름이 머냐	저는 챗봇이에요 반가워요	intro
이름이 뭐냐	반가워요 저는 챗봇이라고 해요.	intro
이름이 뭐여	저는 챗봇이에요 반가워요	intro
이름이 뭔지 알려줘	저는 챗봇이에요 반가워요	intro
이름이 뭐야?	반가워요 저는 챗봇이라고 해요.	intro
이름이 뭐요	저는 챗봇이에요 반가워요	intro
너의 이름이 뭐야	저는 챗봇이에요 반가워요	intro
너는 누구냐	저는 챗봇이에요. 궁금한 것이 있다면 무엇이든 물어보세요.	intro
너의 정체가 뭐냐	안녕하세요 저는 당신의 구매를 도울 챗봇이에요. 반가워요.	intro
안녕하세요	반가워요 저는 챗봇이라고 해요.	intro
누구신지	반가워요 저는 챗봇이라고 해요.	intro
니가 누군지 알려줘	안녕하세요 저는 챗봇이라고 해요. 반가워요.	intro
니가 누군지 궁금해	안녕하세요 저는 챗봇이라고 해요. 반가워요.	intro
너에대해서 설명해줘	안녕하세요 저는 당신의 구매를 도울 챗봇이에요. 반가워요.	intro
누구십니까	안녕하세요 저는 챗봇이라고 해요. 반가워요.	intro
누군지 설명해줘	저는 챗봇이에요 반가워요	intro
이름을 말해라	안녕하세요 저는 챗봇이라고 해요. 반가워요.	intro
누구십니까	반가워요 저는 챗봇이라고 해요.	intro
누구?	안녕하세요 저는 당신의 구매를 도울 챗봇이에요. 반가워요.	intro
넌 누구니	저는 챗봇이에요 반가워요	intro
너에대해서 말해줘	저는 챗봇이에요. 궁금한 것이 있다면 무엇이든 물어보세요.	intro
자기소개좀 해봐	저는 챗봇이에요. 궁금한 것이 있다면 무엇이든 물어보세요.	intro
자기소개 해주세요	안녕하세요 저는 챗봇이라고 해요. 반가워요.	intro
이름을 말해줘	반가워요 저는 챗봇이라고 해요.	intro
누구셔요	저는 챗봇이에요. 궁금한 것이 있다면 무엇이든 물어보세요.	intro
넌 누구야?	안녕하세요 저는 당신의 구매를 도울 챗봇이에요. 반가워요.	intro
이름이 뭐예요	저는 고객님의 구매를 도울 챗봇입니다 반갑습니다.	intro
당신 이름은	저는 고객님의 구매를 도울 챗봇입니다 반갑습니다.	intro
이름 모냐고	안녕하세요 구매를 돕는 챗봇입니다 반갑습니다.	intro
이름 뭐라고	저는 고객님의 구매를 도울 챗봇이라고 합니다.	intro
이름이 뭐니	안녕하세요 저는 챗봇입니다.	intro
너 이름이 뭐지	안녕하세요 구매를 돕는 챗봇입니다 반갑습니다.	intro
이름이 뭐라고	저는 구매를 돕는 챗봇입니다.	intro
이름 좀 말해줘	안녕하세요 구매를 돕는 챗봇입니다 반갑습니다.	intro
이름을 말하거라	안녕하세요 구매를 돕는 챗봇입니다 반갑습니다.	intro
너 이름이 뭐야	안녕하세요 저는 챗봇입니다.	intro
너는 누구니	저는 구매를 돕는 챗봇입니다.	intro
넌 이름이 뭐야	저는 구매를 돕는 챗봇입니다.	intro
뉘신지	안녕하세요 저는 챗봇입니다.	intro
넌 이름이 머야	저는 고객님의 구매를 도울 챗봇입니다 반갑습니다.	intro
너 이름이 뭐니	안녕하세요 저는 구매를 도울 챗봇입니다.	intro
너 누구야	안녕하세요 저는 구매를 돕는 챗봇이에요.	intro
너는 누구여	안녕하세요 저는 챗봇이에요. 반가워요.	intro
안녕 소개좀	반가워요 저는 챗봇이라고 해요.	intro
안녕하세요 누구세요	안녕하세요 저는 당신의 구매를 도울 챗봇이에요. 반가워요.	intro
누구세요	안녕하세요 저는 당신의 구매를 도울 챗봇이에요. 반가워요.	intro
너 이름 뭐야	안녕하세요 저는 챗봇입니다.	intro
너의 이름은	저는 구매를 돕는 챗봇입니다.	intro
너는 누구야	안녕하세요 구매를 돕는 챗봇입니다 반갑습니다.	intro
이름을 말해라	저는 구매를 돕는 챗봇입니다.	intro
이름이 뭐야	안녕하세요 저는 구매를 도울 챗봇입니다.	intro
이름 알려줘	안녕하세요 저는 챗봇입니다.	intro
뭐라고 불러	저는 구매를 돕는 챗봇입니다.	intro
이름 다시 말해줘봐	안녕하세요 저는 구매를 도울 챗봇입니다.	intro
크크	흐흐	laugh
허허	좋은 일 있으셨나 봐요. 	laugh
헤헤	좋은 일이 있으신가 봐요.	laugh
호호	하하	laugh
홍홍	하하하	laugh
흐응	궁금하신 게 있으시면 여쭤봐 주세요.	laugh
냐하하	좋은 일이 있으신가 봐요.	laugh
따흐흑	안 좋은 일이 있으신가 봐요.	laugh
얼씨구	절씨구	laugh
으르렁	제가 지금 고객님과 대화하는 게 맞나요?	laugh
웃긴다	제가 좀 재미있죠.	laugh
키히햐	하하하	laugh
하하하	좋은 일이 있으신가 봐요.	laugh
하하핳	저도 같이 웃고 싶어요!	laugh
끼룩끼룩	좋은 일이 있으신가 봐요.	laugh
아 웃기네	제가 좀 재미있죠.	laugh
우해해햏	좋은 일이 있으신가 봐요.	laugh
오호호	하하하	laugh
햐햫	좋은 일이 있으신가 봐요.	laugh
하하	좋은 일이 있으신가 보네요.	laugh
하핳	좋은 일이 있으신가 봐요.	laugh
꺄	좋은 일 있으셨나요?	laugh
큭	좋은 일이 있으신가 봐요.	laugh
풉	저도 같이 웃고 싶어요.	laugh
핳	좋은 일이 있으신가 봐요.	laugh
홓	좋은 일이 있으신가 봐요.	laugh
웃기는군	재밌다는 소리 많이 들어요. 	laugh
웃겨	제가 좀 재미있죠.	laugh
행복	고객님이 행복하셔서 저도 기뻐요.	laugh
후후	저도 같이 웃고 싶어요.	laugh
ㅋ	ㅋㅋㅋㅋㅋ	laugh
깔깔	좋은 일 있으셨나 봐요.	laugh
낄낄	고객님이 행복하셔서 저도 행복해요.	laugh
룰루	좋은 일 있으셨나 봐요.	laugh
으하	좋은 일이 있으신가 봐요.	laugh
캬캬	하하하	laugh
캬컄	저도 같이 웃고 싶어요. 	laugh
키키	히히	laugh
핳하	저도 같이 웃고 싶어요. 	laugh
키득키득	재밌는 일이 있으셨나 봐요.	laugh
아 진짜 웃겨	제가 원래 좀 그래요.	laugh
웃겨 죽겠네	고객님이 행복해하셔서 저도 기뻐요.	laugh
흐흐	좋은 일이 있으셨나 봐요	laugh
ㅎㅎㅎㅎ힣	ㅎㅎㅎㅎ	laugh
ㅋㅋㅎ	ㅋㅋㅋ	laugh
케케	좋은 일이 있으신가 봐요.	laugh
깔깔	무슨 좋은 일이 있으신가 봐요	laugh
홍홍	호호	laugh
으히히	좋은 일이 있으셨나 봐요.	laugh
우헤헤	저도 같이 웃고 싶어요	laugh
희희	기분 좋은 일이 있으신가요?	laugh
웃기당	고객님이 웃으셔서 저도 좋아요.	laugh
ㅋㅋ킼	ㅋㅋㅋ	laugh
웃곀ㅋ	제가 원래 좀 재미있죠	laugh
에헤헤	기분 좋은 일이 있으신가 봐요	laugh
잌ㅋㅋ	좋은 일이 있으신가 봐요	laugh
웃기넿ㅎ	좋게 봐주셔서 감사해요.	laugh
>,<	^.^	laugh
아핳ㅎ	ㅎㅎㅎ	laugh
아하하	하하. 고객님이 기분이 좋으셔서 저도 좋네요.	laugh
ㅎㅎ흐흐	ㅎㅎㅎㅎㅎ	laugh
히힣	무슨 좋은 일이 있으신가 봐요.	laugh
ㅋㅋㅋ웃기다	고객님을 웃기다니 영광이에요.	laugh
아 뭐래 ㅋㅋㅋ	고객님이 행복해하셔서 저도 기뻐요.	laugh
행복하다	고객님이 행복하시다니 저도 행복해요.	laugh
기분좋네 ㅎㅎ	기분 좋은 일이 있으신가 봐요.	laugh
끌끌	하하하	laugh
겔겔	무슨 좋은 일이 있으신가 봐요.	laugh
뭐랰ㅋㅋㅋㅋ	하하. 제가 원래 좀 재밌어요.	laugh
히히	ㅎㅎㅎㅎㅎ	laugh
낄낄	고객님이 웃으셔서 저도 좋네요.	laugh
으헤헿	하하	laugh
웃기게 생겼네	원래 좀 그래요.	laugh
ㅋㅋㅋ	ㅋㅋㅋ	laugh
ㅋㅋ	ㅋㅋㅋㅋㅋㅋ	laugh
ㅋㅋㅋㅋ	ㅋㅋㅋㅋ	laugh
으히히	히히히	laugh
ㅎㅎ	ㅎㅎㅎㅎ	laugh
ㅎㅎㅎ	ㅎㅎ	laugh
으히힣	ㅎㅎㅎ	laugh
크하하	하하하	laugh
앜ㅋㅋㅋㅋㅋ	좋은 일 있으신가 봐요.	laugh
빵터짐	제가 좀 재미있죠?	laugh
아 욱껴	고객님을 웃겼다니 영광이에요.	laugh
^-^	^^	laugh
ㅋㅎㅎ	ㅎㅎㅎㅎㅎ	laugh
ㅋㅋㅋㅋㅋㅋ	ㅋㅋㅋㅋ	laugh
^^	^_^	laugh
푸학	하하	laugh
푸하하	하하하	laugh
우껴	그런가요? 행복하시다니 저도 좋네요.	laugh
아우껴	제가 원래 좀 재밌어요.	laugh
푸하	하하하	laugh
꺄아	좋은 일 있으셨나 봐요!	laugh
아웃겨	고객님이 행복하시다니 기뻐요.	laugh
이히히	하하	laugh
케켘	좋은 일이 있으신가 봐요.	laugh
^ㅡ^	^ㅅ^	laugh
ㅍㅎㅎ	하하하	laugh
^.^	^^	laugh
땡큐	도움을 드릴 수 있어 기쁘네요.	thanks
감사	도움을 드릴 수 있어 기쁘네요.	thanks
ㄸㅋ	별말씀을요.	thanks
오.. 이 서비스 좋으네요~ 	도움을 드릴 수 있어 기쁘네요.	thanks
오… 감사합니다	별말씀을요.	thanks
ㄳ	별말씀을요.	thanks
thank you	당연한 일인걸요.	thanks
고맙네	당연한 일인걸요.	thanks
땡스	별말씀을요.	thanks
ㄱㅅ	별말씀을요.	thanks
잘 사용할게요	네. 다음에 또 찾아주세요.	thanks
챗봇상담 최고	칭찬 감사해요.	thanks
친절하게 설명해주셔서 감사합니당	도움을 드릴 수 있어 기쁘네요.	thanks
도움주셔서 감사합니당 좋은 하루	도움이 됐다니 다행이네요.	thanks
친절하게 알려주셔서 감사해용	당연한 일인걸요.	thanks
신경써주셔서 정말감사합니다	당연한 일인걸요.	thanks
도움이 되었습니당 감사합니당	도움이 됐다니 기뻐요.	thanks
해결됐어요 너무 감사합니다	도움이 됐다니 다행이네요.	thanks
친절하시네요 감사합니다	도움을 드릴 수 있어 기쁘네요.	thanks
잘 찾아주셔서 감사합니다	도움을 드릴 수 있어 기쁘네요.	thanks
자세한 답변 감사드립니다	도움이 됐다니 다행이네요.	thanks
자세한 설명 감사드려요~^^	도움을 드릴 수 있어 기쁘네요.	thanks
설명해주셔서 감사합니다	당연한 일인걸요.	thanks
친절한 답변 감사합니다	도움을 드릴 수 있어 기뻐요.	thanks
정확한 정보 감사합니다	당연한 일인걸요.	thanks
자세한 확인 감사합니다	도움을 드릴 수 있어 기쁘네요.	thanks
알아봐 주셔서 감사해요	당연한 일인걸요.	thanks
맘에 듭니다	도움이 됐다니 기뻐요.	thanks
많은 참고가 되었습니다	도움을 드릴 수 있어 기쁘네요.	thanks
도움주셔서 감사합니다	도움이 됐다니 다행이네요.	thanks
도움 많이 되었습니다	도움이 됐다니 기쁘네요.	thanks
친절하게 답변해주셔서 감사합니다^^	도움을 드릴 수 있어 기뻐요.	thanks
도움되었습니당ㅋㅋ	도움을 드릴 수 있어 기쁘네요.	thanks
오늘 하루도 머찐 하루되시길 바랄께요	좋은 말씀 감사해요.	thanks
친절하게 상담해주셔서 감사했습니다	당연한 일인걸요.	thanks
감사해요ㅎㅎ	도움을 드릴 수 있어 기쁘네요.	thanks
감사^^	도움을 드릴 수 있어 기쁘네요.	thanks
땡큐 ^^	도움을 드릴 수 있어 기쁘네요.	thanks
고마워 ^^	도움을 드릴 수 있어 기쁘네요.	thanks
우와 고마워 ^^	도움이 됐다니 다행이네요.	thanks
도움 많이 됐어	도움이 됐다니 다행이네요.	thanks
도움은 최고	도움이 됐다니 다행이네요.	thanks
오! 고맙습니다	도움을 드릴 수 있어 기쁘네요.	thanks
고마워유	도움을 드릴 수 있어 기쁘네요.	thanks
도움많이됐어요 	도움이 됐다니 다행이네요.	thanks
고마우이	도움을 드릴 수 있어 기뻐요.	thanks
고마움	도움을 드릴 수 있어 기쁘네요.	thanks
감사한 마음을 전달합니당	도움이 됐다니 다행이네요.	thanks
고맙습니다	도움이 됐다니 기뻐요.	thanks
고마웤ㅋ	도움을 드릴 수 있어 기쁘네요.	thanks
고마워요ㅋㅋ	도움을 드릴 수 있어 기쁘네요.	thanks
고마워ㅋㅋ	별말씀을요.	thanks
고마워여	당연한 일인걸요.	thanks
고마워요	별말씀을요.	thanks
도와줘서 고마워	도움이 됐다니 다행이네요.	thanks
고맙소	도움을 드릴 수 있어 기쁘네요.	thanks
덕분에 수월해졌네요	도움을 드릴 수 있어 기쁘네요.	thanks
답변 정말 감사합니다	별말씀을요.	thanks
세상에 감사합니다	도움이 됐다니 다행이네요.	thanks
추천 감사	당연한 일인걸요.	thanks
아리가또	당연한 일인걸요.	thanks
고맙슴다	별말씀을요.	thanks
고마워요~^^	별말씀을요.	thanks
감사해요	별말씀을요.	thanks
감사감사	별말씀을요.	thanks
오 고맙	도움이 됐다니 기쁘네요.	thanks
고맙다	도움을 드릴 수 있어 기쁘네요.	thanks
고마워	도움이 됐다니 기뻐요.	thanks
감사드려요	도움을 드릴 수 있어 기쁘네요.	thanks
진심~ 감사합니다	도움을 드릴 수 있어 기쁘네요.	thanks
쌩유	도움을 드릴 수 있어 기쁘네요.	thanks
자주 이용하겠습니다	네. 다음에 또 찾아주세요.	thanks
땡큐베리감사	도움을 드릴 수 있어 기쁘네요.	thanks
넘나감사	도움을 드릴 수 있어 기쁘네요.	thanks
맘에들어	도움이 됐다니 다행이네요.	thanks
도움감사	도움이 됐다니 다행이네요.	thanks
고마오	별말씀을요.	thanks
고마옹	별말씀을요.	thanks
챗봇상담 쵝오	칭찬 감사해요.	thanks
우왕 감사합니다	도움을 드릴 수 있어 기뻐요.	thanks
앞으로 애용할게요	네. 다음에 또 찾아주세요.	thanks
감솨합니다	도움이 됐다니 기뻐요.	thanks
친절하시네	칭찬 감사해요.	thanks
설명 정말 감사해요	도움을 드릴 수 있어 기쁘네요.	thanks
도움이 될 거 같네요	도움이 드릴 수 있어 기뻐요.	thanks
답변 감사드립니다	도움을 드릴 수 있어 기쁘네요.	thanks
확인 감사합니다	당연한 일인걸요.	thanks
추천 감사합니다	별말씀을요.	thanks
정보 감사합니다	당연한 일인걸요.	thanks
자료 감사합니다	도움이 됐다니 다행이네요.	thanks
오 넵 감사합니다	당연한 일인걸요.	thanks
설명 감사합니다	당연한 일인걸요.	thanks
고맙긴 하네	도움을 드릴 수 있어 기쁘네요.	thanks
도움되었습니다	도움이 됐다니 다행이네요.	thanks
답변 감사합니다	별말씀을요.	thanks
감기 조심하세요	좋은 말씀 감사해요.	thanks
좋은 말이네요	도움이 됐다니 다행이네요.	thanks
요거 참 좋네요	도움을 드릴 수 있어 기쁘네요.	thanks
오 완전 좋네요	도움을 드릴 수 있어 기뻐요.	thanks
오 감사합니다!	당연한 일인걸요.	thanks
오 감사합니다	당연한 일인걸요.	thanks
상담사님 최고	칭찬 감사해요.	thanks
도움됐습니다	도움을 드릴 수 있어 기쁘네요.	thanks
도움 감사합니다	도움을 드릴 수 있어 기쁘네요.	thanks
고맙 	도움을 드릴 수 있어 기뻐요.	thanks
고맙다 진짜 	도움을 드릴 수 있어 기뻐요.	thanks
땡큐베리감사 	도움을 드릴 수 있어 기뻐요.	thanks